ID,Name,Maths,Science,English,Total
S001,Kristine Ventura,3,39,55,97
S002,Jason Gonzalez,54,3,29,86
S003,Kaye James,31,37,74,142
S004,Jarvis Hardy,95,38,56,189
S005,Jennifer Hermann,24,30,69,123
S006,Beverly Bradwell,54,9,34,97
S007,Toi Beatty,12,65,26,103
S008,Ty Ferguson,57,77,80,214
S009,Sharon Sheriff,100,49,50,199
S010,Robert Samuel,50,11,94,155
S011,James Moon,29,22,47,98
S012,Cathy Montgomery,27,60,75,162
S013,Shirley Bren,63,17,40,120
S014,Jessie Maurin,69,31,61,161
S015,Carlton Serio,50,57,98,205
S016,Hilary Lemire,45,98,80,223
S017,Theodore Wolf,94,9,38,141
S018,Adam Batchelor,56,6,14,76
S019,Sylvia Daisy,4,50,49,103
S020,Pauline Mcwaters,47,10,38,95
S021,Donald Walker,63,93,49,205
S022,Tonya Mccray,81,31,5,117
S023,Carrie Ortiz,87,12,91,190
S024,Don Osteen,54,49,53,156
S025,Melvin Votaw,1,99,7,107
S026,William Gonsalves,41,33,16,90
S027,Isabell Potts,79,83,18,180
S028,George Kleiman,25,27,51,103
S029,Eric Rusboldt,32,70,96,198
S030,Walter Yang,58,5,55,118
S031,William Matthew,0,44,70,114
S032,Katy Gomes,90,17,39,146
S033,Rodney Lemmon,32,17,21,70
S034,Paul Barringer,25,77,28,130
S035,Brian Arnold,43,32,18,93
S036,Marie Redner,90,47,52,189
S037,Margaret Lindhorst,76,11,40,127
S038,Horace Stratter,3,96,42,141
S039,Michael Ashley,33,98,70,201
S040,Rachel Carnagey,17,24,15,56
S041,Timothy Carter,28,3,89,120
S042,David Keeler,36,80,26,142
S043,Garrett Devilbiss,80,3,57,140
S044,Lela Kinkead,15,24,57,96
S045,Kathleen Ballard,59,35,41,135
S046,Bernice Ball,53,61,77,191
S047,Claire Lugo,12,58,33,103
S048,Jennifer Pring,5,66,96,167
S049,Perry Peralta,75,90,69,234
S050,Judith Bannerman,91,14,92,197
S051,Harriett Domina,35,33,83,151
S052,David Ashby,65,6,52,123
S053,Juan Hawkins,47,72,67,186
S054,Elizabeth Bloodsaw,20,21,16,57
S055,Leroy Haller,43,6,78,127
S056,Wanda Stone,68,70,27,165
S057,Pauline Kelly,23,36,15,74
S058,Mary Adriance,36,31,61,128
S059,Daryl Giard,31,79,77,187
S060,Judith Gray,66,51,70,187
S061,Fidel Reid,64,86,84,234
S062,Blanche Williams,32,71,16,119
S063,Joni Huerta,97,23,96,216
S064,Luis Bruhn,26,80,55,161
S065,Bruce Johnson,83,40,49,172
S066,Paul Cohen,72,82,38,192
S067,Richard Covert,11,80,9,100
S068,Sherry Arnold,95,51,19,165
S069,Shaun Brandon,69,75,14,158
S070,Doris Hovermale,45,45,84,174
S071,Tracy Cazier,98,45,54,197
S072,Ryan Bunch,60,91,90,241
S073,Jamie Paquin,60,55,9,124
S074,Patricia Brummell,21,0,1,22
S075,Trent Arriaga,13,75,23,111
S076,Ricky Whitaker,1,82,0,83
S077,Reginald Bobek,91,83,63,237
S078,Sarah Compton,53,53,42,148
S079,Benjamin Sanders,5,23,14,42
S080,Gale Strickland,31,34,94,159
S081,Donald Martinie,6,94,28,128
S082,Ruby Obryan,50,60,60,170
S083,Cynthia Bolden,37,35,90,162
S084,Larry Brown,50,86,26,162
S085,Dessie Moore,99,17,89,205
S086,James Witham,23,12,29,64
S087,Robin Buhmann,64,87,36,187
S088,Clarence Rivers,36,35,43,114
S089,Thelma Ulloa,42,31,86,159
S090,Jannie Cummings,19,64,95,178
S091,Hubert Noland,95,50,37,182
S092,George Lipner,59,94,99,252
S093,David White,14,61,84,159
S094,Melinda Mcbroom,57,12,60,129
S095,Ricardo Evangelista,97,28,86,211
S096,Michelle Garcia,14,30,30,74
S097,Harry Lavigne,33,67,93,193
S098,Sarah Crown,50,72,11,133
S099,Maria Potts,54,83,92,229
S100,Patricia Skelton,14,10,84,108
S101,Richard French,92,0,86,178
S102,Jean Brown,22,80,28,130
S103,Hattie Fabry,54,47,28,129
S104,Michael Elliott,46,95,30,171
S105,Gretchen Pulliam,94,33,76,203
S106,Trish Mcdonald,75,96,56,227
S107,Henrietta Cousins,18,68,22,108
S108,Lisa Robinson,81,73,74,228
S109,Mildred Taylor,100,17,91,208
S110,Dorothy Hackworth,5,49,55,109
S111,Lillian Hile,34,29,10,73
S112,Betty Clark,91,14,73,178
S113,Ben Corley,64,18,92,174
S114,Joshua Cloninger,24,17,43,84
S115,Annie Bliss,100,34,74,208
S116,Margaret White,57,77,29,163
S117,Stuart Sas,31,82,100,213
S118,Marguerite Dorio,74,22,65,161
S119,Paul Case,61,19,42,122
S120,Emile Castillo,90,27,22,139
S121,Brian Divers,16,31,34,81
S122,Lillian Guinn,56,21,90,167
S123,Robert Baydal,92,29,85,206
S124,Micheal Rich,12,43,68,123
S125,Neil Johnston,7,14,37,58
S126,Phillip Crye,4,0,59,63
S127,Robert Allen,52,51,97,200
S128,Bryan Alan,22,48,3,73
S129,Craig Murphy,4,7,99,110
S130,John Howland,5,37,75,117
S131,Gerald Ainsworth,85,14,91,190
S132,Shirley Guzman,99,73,26,198
S133,Doreen Ramirez,57,50,74,181
S134,Clifton Schlenz,59,29,29,117
S135,Donald Freeman,52,85,43,180
S136,Willard Mcclain,20,0,87,107
S137,Maria Hendrick,58,79,2,139
S138,Mattie Wells,45,12,43,100
S139,Kevin Rodriguez,15,58,25,98
S140,Charles Vargas,1,97,96,194
S141,Linda Folks,23,26,94,143
S142,Damon Fredrick,80,86,74,240
S143,Donald Severson,21,0,67,88
S144,Mary Lester,60,57,18,135
S145,Janet Hererra,61,75,25,161
S146,Stevie Mitchell,98,29,33,160
S147,Jason Gregory,21,18,46,85
S148,Curtis Nixon,52,42,79,173
S149,Mike Bell,76,97,61,234
S150,Stephen Fuller,82,30,35,147
S151,Crystal Gannett,59,15,59,133
S152,Kristy Hart,21,91,45,157
S153,Jonathan Adams,1,32,16,49
S154,Ivette Cox,11,61,45,117
S155,Dolores Davis,96,48,55,199
S156,Michael Talavera,22,23,33,78
S157,William Bailey,20,55,54,129
S158,Belinda Alexander,33,14,94,141
S159,John Chambers,42,52,2,96
S160,Deborah Cox,25,84,63,172
S161,David Wilkinson,11,56,41,108
S162,Joshua Stewart,97,65,72,234
S163,Christopher Clark,23,41,22,86
S164,Bill Jones,13,32,0,45
S165,Eliza Thomas,37,4,88,129
S166,David Franklin,82,16,31,129
S167,Donald Lehn,16,60,30,106
S168,Lloyd Phillips,69,69,45,183
S169,Annette Miller,71,68,93,232
S170,Aaron Wiggins,71,74,44,189
S171,Roman Britt,63,89,32,184
S172,Jessica San,0,83,95,178
S173,Ignacio Pinneo,65,90,28,183
S174,Wilbert Bennett,71,100,94,265
S175,James Fleming,22,91,52,165
S176,Edith Carlson,51,38,4,93
S177,Dorthy Culp,73,27,44,144
S178,Erica Duncan,1,66,86,153
S179,Juanita Olsen,82,85,100,267
S180,Marion Barnard,26,55,21,102
S181,Jenette Horn,51,100,25,176
S182,Tony James,8,21,12,41
S183,Luz Dawson,80,79,85,244
S184,Jennifer Brown,70,20,100,190
S185,Robert Vesco,97,28,1,126
S186,Harold Mills,79,47,72,198
S187,Felix Lewis,74,8,64,146
S188,Mildred Smith,54,2,70,126
S189,Gregory Motley,81,20,85,186
S190,Mildred Valdes,24,73,73,170
S191,Wayne Johansen,24,61,85,170
S192,Austin Burney,98,48,35,181
S193,Karen Wilson,90,5,90,185
S194,Monte Folmer,30,54,49,133
S195,Gloria Williams,56,21,15,92
S196,William Pecanty,11,47,35,93
S197,Chris Henderson,44,75,48,167
S198,Daniel Simon,59,88,47,194
S199,William Hood,94,73,21,188
S200,Thomas Willadsen,100,86,48,234
S201,Theresa Hall,54,28,28,110
S202,Heidi Hopkins,73,73,72,218
S203,Wanda Duffy,24,16,10,50
S204,Jose Thibeault,55,77,57,189
S205,Jeffrey Lee,54,38,90,182
S206,Patricia Vallot,72,82,67,221
S207,Mary Copeland,50,12,58,120
S208,Bryan Snavely,77,12,41,130
S209,Gloria Middaugh,89,17,9,115
S210,Bill Summers,77,16,27,120
S211,Rebekah Webb,79,71,90,240
S212,Joseph Huntley,92,80,76,248
S213,Billy Harris,50,91,51,192
S214,Lamont Tilton,65,6,24,95
S215,James Brower,2,54,39,95
S216,Raymond Butler,66,52,32,150
S217,Jan Bubert,70,62,16,148
S218,Ellis Keena,51,54,49,154
S219,Susan Daniels,38,13,17,68
S220,Gerald Marcotte,39,5,33,77
S221,Marianne Barnes,1,34,37,72
S222,Rico Maybury,78,40,78,196
S223,Kyle Hartley,99,35,18,152
S224,Jordon Rosenberger,16,97,59,172
S225,Terry Hammond,88,12,74,174
S226,Jackson Patague,17,3,73,93
S227,Patricia Schulz,80,18,61,159
S228,Thomas Brinkley,13,10,64,87
S229,Kenneth Carter,95,3,66,164
S230,Jimmy Bowles,10,63,48,121
S231,Larry Cox,37,39,10,86
S232,Benita Gomez,63,75,0,138
S233,Christopher Smith,42,48,74,164
S234,Kent Para,29,47,39,115
S235,Alexis Marcum,0,34,15,49
S236,Dominic Wimbush,92,86,99,277
S237,Jolene Mcsween,67,76,51,194
S238,Allen Powell,30,26,93,149
S239,Eddie Betterton,95,17,47,159
S240,Maria Hall,28,9,29,66
S241,John Pilkington,38,27,52,117
S242,Elisabeth Marinas,63,55,84,202
S243,Helen Strickland,54,86,87,227
S244,David Lopez,92,34,33,159
S245,Ester Dirickson,17,54,83,154
S246,Gene Heckman,17,94,57,168
S247,Joseph Rosenberg,20,58,71,149
S248,Traci Freed,43,97,75,215
S249,Toni Revell,11,83,61,155
S250,Anthony Kasahara,64,1,9,74
S251,Ralph Sawyer,17,29,34,80
S252,Tom Tomko,58,48,29,135
S253,Michael Mills,32,57,97,186
S254,Theresa Bilodeau,75,99,35,209
S255,William Lindblad,74,61,21,156
S256,Janet Hernandez,61,53,99,213
S257,Tracy Duran,70,24,72,166
S258,Wilton Coombs,79,67,43,189
S259,Edward Jones,64,50,47,161
S260,Kelley Blackwell,58,54,9,121
S261,Thomas Washington,81,98,51,230
S262,Brittany James,81,8,83,172
S263,Jose Frisco,70,12,35,117
S264,Collette Kerrigan,100,39,66,205
S265,John Roberts,26,46,70,142
S266,Alberto Lombardo,11,92,15,118
S267,Dina Yenz,61,80,62,203
S268,Michael Ewald,70,42,16,128
S269,Jose Bowie,51,80,81,212
S270,Patrick Morse,88,4,43,135
S271,Deborah Speck,30,71,42,143
S272,Rosie Turner,62,75,88,225
S273,Dawn Iler,12,16,99,127
S274,Cathryn Matheson,2,29,69,100
S275,Kenneth Winstead,8,7,9,24
S276,Annette Doney,73,13,93,179
S277,Molly Bennett,39,74,23,136
S278,Marvin Sine,26,31,54,111
S279,David Bach,62,50,48,160
S280,Jennie Batz,9,12,85,106
S281,Brian Williamson,3,70,55,128
S282,Mary Ratliff,98,29,95,222
S283,Charlene Doe,21,84,58,163
S284,Charles Collins,21,9,11,41
S285,Louis Allen,9,24,17,50
S286,Nicole Mcdonald,65,98,33,196
S287,Joshua Szaflarski,57,51,8,116
S288,John Hernandez,66,73,76,215
S289,Caleb Castro,16,74,74,164
S290,Elizabeth Nay,3,2,13,18
S291,Karen Cornett,25,69,84,178
S292,Henry Hogan,68,22,65,155
S293,Darryl Bilbo,61,64,80,205
S294,Paul Bose,92,98,32,222
S295,Margaret Magera,57,34,84,175
S296,James Jackson,88,46,14,148
S297,John Hulse,43,97,19,159
S298,Troy Johnson,89,78,8,175
S299,Jody Ruybal,13,65,2,80
S300,Mark Goebel,26,16,19,61
S301,Jacob Sayre,85,54,74,213
S302,Bonita Grey,88,52,90,230
S303,Steven Austin,8,0,13,21
S304,Lisa Perrone,54,76,82,212
S305,Robert Troise,38,89,38,165
S306,Ben Haraway,94,83,11,188
S307,Brenda Meyer,95,44,58,197
S308,Donald Brown,19,51,65,135
S309,Steve Little,58,22,23,103
S310,Anthony Brown,37,89,8,134
S311,Phuong Stricker,78,6,74,158
S312,Robert Aguiar,25,86,82,193
S313,Pamela Goodrich,14,30,96,140
S314,Brian Abel,84,58,81,223
S315,Andrew Bodily,54,51,76,181
S316,Theodore Vergin,81,14,27,122
S317,Nicole Heinecke,7,49,79,135
S318,Valerie Myers,46,6,51,103
S319,Patrick Francis,36,74,42,152
S320,Eleanor Schulte,61,79,9,149
S321,Mildred Kulesa,67,33,54,154
S322,Mara Lamblin,64,69,50,183
S323,Marsha Teyler,69,30,78,177
S324,Billie Grooms,81,74,46,201
S325,Anthony Spencer,80,56,64,200
S326,Belinda Metzler,1,30,17,48
S327,Pete King,98,90,12,200
S328,Timothy Duwe,3,59,70,132
S329,Anna Begin,13,80,66,159
S330,Manuel Bielinski,50,61,93,204
S331,Kenneth Cottrell,43,27,87,157
S332,Mark Peart,48,34,94,176
S333,Susan Lee,68,60,52,180
S334,Janetta Mallory,19,11,80,110
S335,Tracey Hill,48,61,58,167
S336,Debra Hough,27,44,47,118
S337,Patrica Gonzalez,67,20,62,149
S338,John Hamilton,19,59,88,166
S339,Dolores Mccalmont,87,58,24,169
S340,Donnie Daffin,13,27,74,114
S341,Eric Griffin,82,53,64,199
S342,David Crouse,60,52,50,162
S343,Edith Garcia,24,92,73,189
S344,Martha Torsiello,14,32,50,96
S345,Steven Beckum,60,21,28,109
S346,Joshua Garcia,31,45,6,82
S347,Diane Sheridan,99,61,74,234
S348,Herman Collins,97,89,45,231
S349,Merle Brandy,5,53,6,64
S350,William Joiner,34,2,73,109
S351,Douglas Avera,23,50,5,78
S352,Eddie Smith,2,80,44,126
S353,Robert Klingenberger,67,87,98,252
S354,Victor Wright,22,12,75,109
S355,Todd Gilliam,3,29,76,108
S356,Norma Pemberton,88,77,3,168
S357,Jacob Jones,27,59,8,94
S358,Diana Gill,45,59,91,195
S359,Ricky Walter,6,49,11,66
S360,Stephanie Mcguire,66,34,3,103
S361,Craig Easton,48,62,12,122
S362,Antoinette Gipson,54,2,97,153
S363,Bernadette Rudman,35,74,88,197
S364,Curtis Rivera,10,27,68,105
S365,Henry Healy,0,100,10,110
S366,David Raulston,56,52,56,164
S367,Jeffrey Wikoff,6,15,7,28
S368,George Ellis,44,77,23,144
S369,Monica Jones,72,43,37,152
S370,Sarah Dockery,29,5,30,64
S371,Lester Danforth,59,53,90,202
S372,Margaret Lapoint,17,49,96,162
S373,Ruby Davis,85,51,17,153
S374,Lillie Smalley,100,18,54,172
S375,Christopher Russell,63,54,26,143
S376,Betty Estep,59,16,90,165
S377,Karl Steen,18,65,67,150
S378,Eleanor Pagan,23,14,71,108
S379,Ronald Violette,88,45,38,171
S380,Sarah Hearne,86,71,34,191
S381,Roy Wibbens,32,2,35,69
S382,Charlene Snyder,95,2,84,181
S383,Kendal Oliver,91,51,100,242
S384,Keith Granger,88,40,78,206
S385,George Lee,30,62,34,126
S386,Henry Walker,20,59,51,130
S387,John Watkins,33,76,47,156
S388,Shannon Osorio,60,25,74,159
S389,Juanita Sheffield,69,9,96,174
S390,Barbara Stephens,14,89,62,165
S391,Toni Coutee,37,15,18,70
S392,Mark Goodrum,86,78,29,193
S393,Benjamin Kunze,45,92,9,146
S394,Lisa Strahm,88,93,86,267
S395,Andrew Grazier,38,65,40,143
S396,Eric Arnold,17,71,28,116
S397,Laura Cedeno,61,5,50,116
S398,John Tibbs,100,85,45,230
S399,Ella Ward,9,43,39,91
S400,Jennifer Lamar,56,80,0,136
S401,Todd Richardson,16,27,6,49
S402,Jenna Frazier,16,14,21,51
S403,Christine Cutler,15,19,80,114
S404,Robert Levi,53,20,71,144
S405,Noella Britcher,87,74,87,248
S406,Marilyn Berger,22,36,2,60
S407,Marion Rivas,25,67,68,160
S408,Deborah Wilson,78,13,94,185
S409,Rita Pults,71,3,40,114
S410,Emily Jones,20,13,77,110
S411,Stephen Dower,58,22,71,151
S412,Raymond Thom,13,63,60,136
S413,Robert Simpson,65,84,66,215
S414,Seth Joyce,45,33,50,128
S415,John Hassinger,28,12,23,63
S416,Maxine Obrien,19,3,66,88
S417,Donna Rucker,49,69,80,198
S418,Jodie Walker,91,30,42,163
S419,Alice Schwald,87,52,18,157
S420,Nicole Weltha,90,33,75,198
S421,Michael White,81,61,88,230
S422,Harold Wacker,39,93,90,222
S423,Terry Toney,60,95,43,198
S424,Mary Hendon,67,17,34,118
S425,Sharyn Bowers,90,87,63,240
S426,Donald Houston,36,52,59,147
S427,Ferdinand Richard,42,68,96,206
S428,Eric Critchfield,8,1,37,46
S429,Travis Snow,98,65,82,245
S430,Barbara Griffin,76,60,93,229
S431,Delores Dunbar,32,40,69,141
S432,Lori Wiggins,87,52,64,203
S433,Betty Pierce,5,21,24,50
S434,Elizabeth Young,12,0,21,33
S435,Brenda Purnell,18,43,80,141
S436,Joseph Delosantos,57,48,19,124
S437,Steven Bennett,51,89,7,147
S438,Rhonda Bulmer,9,3,67,79
S439,Ronald Swearingen,77,95,9,181
S440,Christopher Serrano,79,87,99,265
S441,Beverly Posey,59,61,25,145
S442,Katherine Furth,74,76,15,165
S443,Maria Everett,27,84,87,198
S444,Guadalupe Lumpkin,7,92,12,111
S445,Jean Turner,45,61,54,160
S446,Soledad Lawson,26,15,91,132
S447,Iva Derentis,85,53,50,188
S448,Shirley Garrell,62,39,73,174
S449,Jennifer Loy,99,15,0,114
S450,Gladys Sjogren,98,39,37,174
S451,Luke Torkelson,2,65,62,129
S452,Patsy Ryals,6,65,93,164
S453,Gita Rogers,21,2,85,108
S454,James Gillins,31,48,64,143
S455,Corey Edington,23,98,61,182
S456,Lance Dickerson,19,49,36,104
S457,Henrietta Mckibben,44,77,30,151
S458,Linda Martino,97,40,0,137
S459,Gina Parks,13,70,33,116
S460,Andrea Dudley,66,99,29,194
S461,Jessica Fawbush,50,63,60,173
S462,Gloria Schleider,88,99,54,241
S463,Kimberly Haven,90,56,49,195
S464,Dorothy Olmstead,87,56,22,165
S465,Kenneth Lamb,93,98,98,289
S466,Genevieve Baker,96,98,68,262
S467,Rose Crouch,61,0,58,119
S468,Stacey Frantz,51,73,16,140
S469,William Stackhouse,43,15,31,89
S470,George Macon,43,14,54,111
S471,Willie Gordon,43,0,7,50
S472,Melanie Marks,84,81,58,223
S473,William Hudson,63,37,80,180
S474,Joseph Frey,22,25,47,94
S475,Maxine Masters,82,44,75,201
S476,Allison Weintraub,24,69,30,123
S477,Dennis Thomas,86,73,53,212
S478,Mike Smith,12,33,70,115
S479,Grace Jacocks,2,54,85,141
S480,Robert Clifton,21,29,37,87
S481,John Maze,25,42,96,163
S482,Helen Mosley,68,24,55,147
S483,Ruth Williams,0,82,26,108
S484,Kimberly Eikenberry,67,7,43,117
S485,Megan Mcgee,0,14,75,89
S486,Shawn Steptoe,85,81,52,218
S487,Jeffrey Odell,17,47,30,94
S488,Melba Forsmark,33,41,7,81
S489,Teresa Summers,17,53,78,148
S490,Jeannie Duckworth,79,14,80,173
S491,Susan Anderson,51,30,35,116
S492,Angela Fujioka,61,95,90,246
S493,John Norton,77,0,60,137
S494,Cheryl Langenfeld,9,80,4,93
S495,Heather Paschall,87,94,53,234
S496,Vera Flynn,49,6,31,86
S497,Gary Welch,24,94,73,191
S498,Edward Hedrington,10,13,50,73
S499,Harold Kakani,7,2,3,12
S500,Paul Shapiro,56,16,20,92
S501,Ryan Carter,53,80,47,180
S502,Teri Williams,45,29,20,94
S503,Jeffrey Grove,18,31,90,139
S504,Cathryn Wyman,77,21,35,133
S505,Lois Townsend,50,89,50,189
S506,Diana Carpenter,89,72,4,165
S507,Phillip Bonner,84,10,47,141
S508,Maureen Allen,10,19,68,97
S509,John Kerley,34,29,41,104
S510,Sadie Spangler,57,37,76,170
S511,Christopher Oneill,29,50,90,169
S512,Carmen Alvarez,3,38,16,57
S513,Patrica Manning,93,11,23,127
S514,Neta Lanterman,100,99,21,220
S515,Margarita Miller,12,38,79,129
S516,Rose Curtis,24,99,51,174
S517,Alice Wolfe,11,85,97,193
S518,Rhea Tonge,67,40,69,176
S519,Rebecca Wells,33,88,48,169
S520,Audrey Banta,26,99,64,189
S521,James Gorrell,95,96,51,242
S522,Gerda Mudget,32,57,68,157
S523,Barbara Martinez,25,39,55,119
S524,Heather Garcia,42,2,85,129
S525,Nancy Bowes,95,74,54,223
S526,Linda Pugh,49,54,39,142
S527,James Morris,73,64,4,141
S528,Leonida Mirza,17,5,95,117
S529,Matthew Archambault,67,93,39,199
S530,Jack Daniels,98,1,33,132
S531,Kimberly Grewe,26,13,10,49
S532,David Cannaday,9,83,41,133
S533,Jonathan Sokolowich,42,48,7,97
S534,Theresa Witt,4,10,25,39
S535,Michael Williams,26,46,29,101
S536,Michelle Boggs,19,23,44,86
S537,Danielle Gauthier,18,0,88,106
S538,Callie Cunningham,62,5,35,102
S539,Kathleen Niles,74,26,92,192
S540,Oscar Yung,63,8,21,92
S541,Brenda Rodriguez,89,17,90,196
S542,Derek Matthews,33,45,11,89
S543,Matthew Bessemer,93,62,62,217
S544,Mary Contreras,100,44,3,147
S545,Barbara Scott,96,33,74,203
S546,Stacie Anderson,24,87,60,171
S547,Karen Barrett,53,15,81,149
S548,Robert Davis,5,36,12,53
S549,Linda Nolan,98,12,23,133
S550,Jack Johnson,27,4,19,50
S551,Beulah Anderson,55,38,19,112
S552,Peggy Rodgers,67,19,57,143
S553,Ann Bolender,78,2,85,165
S554,Kaitlyn Guy,64,29,35,128
S555,Lillian Mclaughlin,17,30,41,88
S556,Carl Jones,78,41,35,154
S557,Jay Kelly,18,43,46,107
S558,Renee Newman,29,78,96,203
S559,Stephen Breaud,20,8,63,91
S560,Maureen Norrix,20,78,87,185
S561,Mario Clark,63,67,66,196
S562,Steven Cloutier,22,5,78,105
S563,Helen Canada,46,7,63,116
S564,Dawn Sims,5,60,66,131
S565,Gerald Brooks,25,29,76,130
S566,Rosemary Boswell,60,92,68,220
S567,Minnie Bates,78,74,37,189
S568,Steven Vincent,54,68,90,212
S569,Ellen Pendry,41,32,43,116
S570,Blanche Moore,3,13,58,74
S571,Vernon Everitt,99,60,39,198
S572,Kathy Maymon,34,22,75,131
S573,Gilbert Williams,69,27,6,102
S574,Derek Landers,25,10,78,113
S575,Christopher Walker,7,5,38,50
S576,Laverne Jackson,97,46,97,240
S577,Julian Tada,13,43,24,80
S578,Carole Gorby,65,31,91,187
S579,Truman Wilcox,89,79,23,191
S580,Nick Delarosa,65,25,53,143
S581,Kristen Sheridan,69,40,3,112
S582,Donald Nunez,63,94,53,210
S583,Christa Hoefling,6,34,1,41
S584,James Zabala,80,80,89,249
S585,Gus Mitchell,17,27,95,139
S586,James Neal,4,53,48,105
S587,Helen Rhodes,75,57,54,186
S588,Linda Huett,79,58,40,177
S589,James Freyman,64,33,96,193
S590,Patricia Torres,79,3,79,161
S591,John Bozych,43,94,39,176
S592,Bruce Juan,49,38,6,93
S593,Edward Eversoll,63,26,0,89
S594,Joey Carr,66,96,100,262
S595,Talia Marson,10,55,93,158
S596,Ruby Palmer,89,5,16,110
S597,Joann Quinn,97,64,68,229
S598,David Sheppard,25,18,36,79
S599,Jessica Ross,81,86,40,207
S600,Virginia Davis,76,50,21,147
S601,Rosa Davis,14,27,12,53
S602,Michael Holliday,13,63,63,139
S603,Allyson Coakley,41,54,17,112
S604,Gussie Baker,50,70,100,220
S605,Kevin Smith,100,57,62,219
S606,Mary Hendershot,84,3,32,119
S607,Valerie Boor,58,79,19,156
S608,Vicki Lafountain,57,93,29,179
S609,Jim Jones,8,53,34,95
S610,Jason Blanton,58,84,99,241
S611,Katherine Fullilove,23,77,76,176
S612,Shirley Stark,6,59,19,84
S613,Jeanette Arroyo,57,76,77,210
S614,George James,40,70,76,186
S615,Fidel Shearer,55,13,37,105
S616,Alan Boyle,94,35,26,155
S617,Grady Miner,25,11,38,74
S618,William Murphy,8,56,11,75
S619,Matthew Welsh,7,92,74,173
S620,James Sadler,29,20,35,84
S621,Trudy Adams,44,51,93,188
S622,Wilmer Leflore,1,74,81,156
S623,Daniel Webb,49,38,22,109
S624,William Solano,34,77,43,154
S625,Cynthia Harrod,83,7,14,104
S626,Dolores Leach,19,39,26,84
S627,Michael Braddy,29,56,17,102
S628,Irene Jones,73,57,75,205
S629,Phillip Stewart,5,29,55,89
S630,Bryan Mccoy,74,50,18,142
S631,Kyle Franzen,19,39,93,151
S632,Elliott Shaffer,10,78,71,159
S633,Gregory Pullen,11,76,84,171
S634,Amy Scala,13,10,48,71
S635,Britney Knight,47,46,3,96
S636,Luis Furst,89,5,98,192
S637,Alan Sanchez,8,7,86,101
S638,Hattie Brown,13,80,14,107
S639,Yolanda Sherburne,24,53,55,132
S640,Sherry Glass,0,71,35,106
S641,Kenny Bleau,34,67,9,110
S642,Robert Bligen,63,61,3,127
S643,Luis Brooks,7,35,1,43
S644,Alisa Roland,37,100,14,151
S645,Edward Lewis,22,32,7,61
S646,Russell Briz,48,86,87,221
S647,Nancy Young,85,64,24,173
S648,Ashley Oliver,37,24,54,115
S649,Charles Kennedy,52,90,21,163
S650,Rebecca Herrera,68,14,2,84
S651,Joseph Perales,22,81,11,114
S652,Anna Thornton,23,40,68,131
S653,Donald Hansen,11,25,68,104
S654,Paul Smith,41,38,36,115
S655,Mario Mattox,35,17,24,76
S656,Dorothy Brodowski,11,15,59,85
S657,Dolly Hunter,48,37,28,113
S658,Sheena Romaniak,92,39,36,167
S659,Tracy Kuck,1,69,60,130
S660,Gregg Noonan,80,9,5,94
S661,Mary Clay,39,40,72,151
S662,Eula Roddy,16,54,78,148
S663,Cory Crowe,77,96,9,182
S664,Robert Melton,99,1,100,200
S665,Paul Pineda,6,25,60,91
S666,Scotty Santo,57,41,8,106
S667,Roberta Vandam,8,78,91,177
S668,Katie Leonard,92,87,91,270
S669,Daniel Hodges,72,22,10,104
S670,Deborah Sulc,65,31,62,158
S671,Robert Briggs,38,7,9,54
S672,Howard Rojas,40,33,50,123
S673,Anna Banda,95,69,72,236
S674,Carmen Pederson,85,72,84,241
S675,Odell Ferrar,1,16,70,87
S676,Marion Taylor,38,38,25,101
S677,Albert Sweet,16,4,2,22
S678,Nicholas Sperry,72,77,36,185
S679,Ella Scheppke,45,88,39,172
S680,Josiah Speece,51,23,71,145
S681,James Vanwoert,0,31,53,84
S682,Karen Causey,38,18,3,59
S683,Joseph Blain,64,66,58,188
S684,Joaquin Mccord,32,89,53,174
S685,Jennifer Williams,10,12,5,27
S686,Kay Bringle,11,96,79,186
S687,Jerry Jagers,91,85,68,244
S688,Kathy Atkison,71,46,7,124
S689,Barbara Koch,88,80,56,224
S690,Helen Miles,97,26,95,218
S691,Becky Dykstra,90,26,43,159
S692,Guy Roberts,84,98,60,242
S693,Velma Ahmad,74,18,96,188
S694,Kevin Lerud,22,9,12,43
S695,William Daugherty,15,86,7,108
S696,Steven Hazlett,57,85,65,207
S697,Angela Brieno,66,34,65,165
S698,Douglas Parks,14,2,60,76
S699,Edna Walsh,15,56,27,98
S700,Benjamin Vanwoert,94,21,37,152
S701,Ronald Thompson,76,33,15,124
S702,Daniel Griffin,34,69,62,165
S703,Buck Lowe,100,61,24,185
S704,Francisca Buoy,53,88,49,190
S705,Vernon Gismondi,12,60,73,145
S706,Robert Atkins,31,50,4,85
S707,Patrick Valdez,39,59,7,105
S708,Lynette Russ,44,66,81,191
S709,Leola Borke,100,40,10,150
S710,Karla Kidwell,95,82,83,260
S711,Emily Gibson,9,81,46,136
S712,Travis Cross,44,22,39,105
S713,Robert Buffin,4,100,60,164
S714,Judy Barrett,32,94,99,225
S715,Joseph Petterson,14,51,22,87
S716,Donald Kaufman,77,50,35,162
S717,Deborah Lopez,82,88,42,212
S718,Nora Lauseng,48,52,33,133
S719,Charles Darden,48,33,63,144
S720,Kimberly Rowland,20,48,35,103
S721,Susan Greenfeld,27,62,99,188
S722,Carroll Schlueter,35,47,100,182
S723,David Brewster,69,88,34,191
S724,Eddie Bordner,10,15,52,77
S725,David Vause,72,92,25,189
S726,Arnold Keegan,69,99,2,170
S727,Celena Harrell,33,36,42,111
S728,Joseph Manz,95,17,29,141
S729,Jonathan Hughes,35,82,85,202
S730,Holly Roye,69,96,97,262
S731,Tonya Zeigler,61,66,82,209
S732,Kathryn Williemae,17,25,76,118
S733,Jamie Alto,43,83,29,155
S734,Myriam Edwards,52,95,63,210
S735,Audrey Guzman,86,81,58,225
S736,Marissa Rifenbark,3,53,51,107
S737,Nina Copeland,9,96,47,152
S738,Sherry Ogawa,85,35,24,144
S739,Nelda Mattern,72,51,20,143
S740,Ruth Martin,75,0,79,154
S741,Charlie Foley,77,0,9,86
S742,Kathryn Graves,100,82,60,242
S743,Jerri Freedman,58,78,10,146
S744,William Velasco,56,37,53,146
S745,Ronnie Chaisson,70,28,51,149
S746,Ronda Anderson,85,58,35,178
S747,Sally Vilain,66,31,98,195
S748,Frank Mcghee,93,15,23,131
S749,Wallace Lona,87,20,51,158
S750,Sherman Parker,79,78,77,234
S751,Susan Greenberg,88,18,60,166
S752,Jose Jordon,53,10,30,93
S753,Georgia Renfro,17,61,4,82
S754,Kristofer Fernandez,43,10,83,136
S755,Catherine Su,81,63,38,182
S756,Derek Perez,75,69,63,207
S757,Noel Matton,41,93,4,138
S758,Paul Simonson,71,39,21,131
S759,Stanley Debois,74,38,36,148
S760,Carlos Jaculina,93,88,25,206
S761,Maurice Mcintire,64,29,94,187
S762,Danielle Meyers,97,27,10,134
S763,Kelli Evans,60,88,77,225
S764,Jay Lam,16,77,90,183
S765,Robert Vanwagoner,20,8,67,95
S766,Thurman Dafonte,34,40,14,88
S767,Lillian Oakley,6,84,47,137
S768,Tillie Hattley,62,4,76,142
S769,Zachery Skeen,82,51,71,204
S770,Jeanne Arndt,31,26,85,142
S771,Judy Curly,14,70,32,116
S772,Bruce Hendricks,39,47,68,154
S773,Renee Hao,35,13,68,116
S774,James Williams,81,15,35,131
S775,Teresa Patterson,57,95,57,209
S776,Susan Youngman,13,79,49,141
S777,Harold Abeles,76,98,83,257
S778,Tammie Jackson,14,74,33,121
S779,Thomas Kelleher,21,38,37,96
S780,Rachel Perrella,76,57,71,204
S781,Diane Fernandez,71,48,99,218
S782,Lynn Perez,49,95,0,144
S783,Steven Shearer,70,56,99,225
S784,George Nesbit,59,2,95,156
S785,Ronnie Queen,66,59,36,161
S786,Fred Travers,84,39,12,135
S787,Tricia Rucker,66,68,98,232
S788,Helen Washington,69,90,39,198
S789,Steven Saraf,32,65,90,187
S790,William Costello,97,17,34,148
S791,Tammy Galioto,53,39,41,133
S792,James Meese,71,6,84,161
S793,Thomas Burke,93,58,80,231
S794,Daniel Hill,92,54,18,164
S795,Victor Underland,55,77,52,184
S796,John Syers,70,4,68,142
S797,Joseph Liles,86,86,68,240
S798,Frederick Montgomery,51,64,37,152
S799,Frank Shoup,61,84,56,201
S800,James Goehner,37,72,48,157
S801,Michael Mcginnis,91,49,98,238
S802,Johnnie Simmons,6,93,68,167
S803,Jorge Ludwig,80,53,46,179
S804,William Nordhoff,19,71,45,135
S805,Erica Thruman,24,83,27,134
S806,Leta Rainey,70,98,30,198
S807,Juan Sierra,43,28,31,102
S808,Audrey Cloninger,49,5,42,96
S809,Debbie Arriola,78,81,15,174
S810,Wayne Ellis,25,61,98,184
S811,Julie Soto,45,51,53,149
S812,Paula Valencia,36,85,86,207
S813,Karen Rowan,99,80,1,180
S814,David Hodson,32,45,2,79
S815,Elaine Bruno,33,52,29,114
S816,Hector Vargas,81,19,86,186
S817,David Whitley,78,22,71,171
S818,Oscar Mcdonald,9,45,79,133
S819,Colene Itson,41,5,76,122
S820,Chris Paris,88,92,93,273
S821,Alberto Padilla,4,74,97,175
S822,Agnes Stedman,55,39,56,150
S823,Robert Wilson,18,97,89,204
S824,Amanda Rybka,43,47,62,152
S825,Gertrude Owens,18,32,86,136
S826,John Keeton,56,83,65,204
S827,James Phillips,26,66,58,150
S828,Debbie Correa,98,20,41,159
S829,Michael Kitchen,87,40,58,185
S830,Dennis Hartmann,46,24,25,95
S831,Lynn Micheau,37,84,95,216
S832,William Barlow,0,75,62,137
S833,Haley Garnett,66,76,17,159
S834,Wesley Croom,57,44,91,192
S835,Laura Delang,46,53,59,158
S836,Cheryl Hayes,22,32,60,114
S837,Greg Lapierre,54,28,21,103
S838,Gertrude Griggs,98,4,84,186
S839,Olivia Griffin,96,73,12,181
S840,Teresa Coleman,88,49,52,189
S841,Dion Harper,96,10,89,195
S842,Irma Cartwright,83,80,53,216
S843,Lloyd Fox,81,25,34,140
S844,Marcos Smith,94,80,2,176
S845,Bruno Larkin,100,29,52,181
S846,David Haworth,45,40,2,87
S847,Charles Desorcy,8,93,56,157
S848,Doris Kidder,63,90,92,245
S849,Louise Macvane,100,92,64,256
S850,Brenda Oglesby,57,55,30,142
S851,Dawn Swanson,68,83,38,189
S852,Peter Valadez,62,99,10,171
S853,Stephen Nixon,60,22,82,164
S854,Virginia Smith,70,83,12,165
S855,Misty Sanchez,2,16,26,44
S856,Paul Bowers,93,32,9,134
S857,Ulrike Motley,65,86,0,151
S858,Rebecca Iniguez,43,0,59,102
S859,Kerry Taylor,48,25,46,119
S860,Amy Lawrence,33,88,62,183
S861,Randy Boucher,81,21,82,184
S862,Numbers Ehrhart,55,2,77,134
S863,Lorenzo Smith,81,84,63,228
S864,William Hronick,54,80,45,179
S865,Mark Griffin,75,91,63,229
S866,Jonathan Mohamed,80,64,11,155
S867,Steven Lee,35,2,36,73
S868,Philip Dumas,5,21,81,107
S869,Howard Stanfa,19,68,42,129
S870,Douglas Carroll,88,16,36,140
S871,Anne Hobbs,41,76,52,169
S872,Kenneth Callahan,73,36,54,163
S873,Dee Sandoval,16,61,51,128
S874,Courtney Kassin,30,65,67,162
S875,Jonathan Stephenson,40,93,10,143
S876,Laura Ascolese,13,41,37,91
S877,Judy Stewart,15,91,67,173
S878,Norma Borden,4,90,2,96
S879,Julian Pagel,28,17,16,61
S880,Stephen Shropshire,33,11,14,58
S881,Martin Caudle,15,30,43,88
S882,Richard Smith,19,20,45,84
S883,Sarah Arias,100,9,45,154
S884,Amanda Novak,75,23,39,137
S885,James Dyer,9,77,97,183
S886,Ying Stanford,74,31,100,205
S887,Della Macdowell,1,13,61,75
S888,Kim Trent,44,81,30,155
S889,Corey Scholz,42,25,17,84
S890,Ramon Alexander,4,27,89,120
S891,Brittany Cacy,23,66,60,149
S892,Vanessa Dalton,2,14,18,34
S893,Gerardo Brooks,30,35,59,124
S894,Luz Darnell,44,82,12,138
S895,Donald Reyes,76,31,10,117
S896,Calvin Wright,25,76,63,164
S897,Patrick Gresham,45,64,79,188
S898,Warren Lange,18,62,8,88
S899,Debbie Larrivee,15,65,73,153
S900,Rebecca Roca,24,89,73,186
S901,Patricia Hite,97,81,53,231
S902,Nancy Jones,38,18,84,140
S903,Jennifer Seling,65,2,46,113
S904,Kevin Meyer,63,49,18,130
S905,Benjamin Clark,82,6,36,124
S906,Terrell Geisler,45,68,56,169
S907,Minerva Mcguffin,51,42,34,127
S908,Winston Archambault,11,1,89,101
S909,Edmund Kirkland,51,47,41,139
S910,David Cuthill,99,28,21,148
S911,Darnell Lanzi,64,18,92,174
S912,Tony Brown,33,73,55,161
S913,Anthony Hughes,1,51,69,121
S914,Anne Osborne,17,97,78,192
S915,Philip Haley,96,17,91,204
S916,Tommy Lamb,50,81,30,161
S917,James Lewis,13,64,84,161
S918,John Simcox,73,78,52,203
S919,Julie Harris,74,58,60,192
S920,Dolores Sison,7,46,37,90
S921,Jeanette Cole,82,32,31,145
S922,Nicholas Rogers,92,99,79,270
S923,Penny Morton,27,92,41,160
S924,Lois Ruthledge,63,12,98,173
S925,Juanita Sanchez,17,8,62,87
S926,Ramon Ferrara,28,41,97,166
S927,Hyman Gates,30,37,74,141
S928,Jose Towery,40,13,77,130
S929,Lise Tubbs,25,3,72,100
S930,Richard Edwards,82,7,5,94
S931,Shannon Kirkpatrick,23,33,45,101
S932,Rheba Martin,43,55,65,163
S933,Jose Bussen,57,5,10,72
S934,Evelyn Kistler,54,88,33,175
S935,Brenda Vella,9,3,9,21
S936,Myrtle Graham,93,50,49,192
S937,Tina Kaya,83,13,85,181
S938,Melvin Wood,64,9,36,109
S939,Wilda Balmer,78,12,27,117
S940,Stephanie Finch,27,97,56,180
S941,Donna Gatling,1,12,14,27
S942,Lloyd Gilmour,75,53,22,150
S943,Stanley Claggett,19,21,93,133
S944,Mark Riley,48,85,88,221
S945,Kenneth Williams,76,42,14,132
S946,Lori Vickers,66,51,6,123
S947,Elaine Marks,31,37,95,163
S948,Tracy Stuckey,95,73,44,212
S949,Mary Couture,89,92,33,214
S950,Jennifer Madison,58,38,39,135
S951,Edward Ballard,73,11,10,94
S952,David Pineau,7,84,45,136
S953,Jack Peyton,65,51,61,177
S954,Robert Bell,30,15,39,84
S955,Katharine Martin,5,90,40,135
S956,James Thomas,38,51,30,119
S957,Jacqueline Berry,98,30,29,157
S958,Carlos Gannaway,58,99,46,203
S959,Kathy Northey,78,79,1,158
S960,Maura Waller,23,25,56,104
S961,Dorothy Beatty,56,57,79,192
S962,Teresa Mallory,1,41,92,134
S963,Richard Nagy,77,82,51,210
S964,Ruby King,27,21,12,60
S965,Nettie Smith,39,88,51,178
S966,Peggy Wood,51,80,88,219
S967,Dania Romero,2,58,82,142
S968,Wayne Smith,16,50,3,69
S969,Richard Stpierre,31,5,97,133
S970,Edna Johnson,25,60,57,142
S971,Christin Zuniga,12,25,13,50
S972,Rudy Cooley,44,98,74,216
S973,John Bennett,79,43,27,149
S974,Kevin Estrada,69,83,39,191
S975,Daniel Rasco,83,23,8,114
S976,Alicia Randolph,88,69,32,189
S977,Amanda Jump,10,91,92,193
S978,Karen Jefferson,6,6,93,105
S979,Robert Arrey,48,57,7,112
S980,Lance Maring,99,1,95,195
S981,Linda Ball,10,27,26,63
S982,Josephine Cail,73,81,23,177
S983,Allen Henry,85,79,42,206
S984,Gary Hirkaler,26,26,33,85
S985,Tony Mckinney,15,67,4,86
S986,Elizabeth Leser,99,14,76,189
S987,Junie Whit,97,23,17,137
S988,Mary Smith,52,51,57,160
S989,Tonya Biffle,23,38,23,84
S990,Christopher Richter,38,49,77,164
S991,Helen Fitzpatrick,24,28,60,112
S992,Shayne Fusco,99,67,55,221
S993,Eleanor Diaz,63,79,94,236
S994,Jessie Cooper,20,75,85,180
S995,John Campos,53,91,24,168
S996,Sharla Yerian,30,46,18,94
S997,Carol Hahn,2,58,68,128
S998,Thomas Jackson,73,36,84,193
S999,Debra Britt,44,5,83,132
S1000,Clarence Rivera,8,35,71,114
S1001,Ron Roach,95,48,79,222
S1002,Kara Patterson,12,17,43,72
S1003,James Hancock,56,7,97,160
S1004,Craig Mccarver,75,41,7,123
S1005,Anna Anderson,62,35,16,113
S1006,Susan Coughlin,9,32,68,109
S1007,Rodney Rufe,78,49,57,184
S1008,Blanche Surratt,45,78,44,167
S1009,Denise Pomrenke,28,47,64,139
S1010,Anne Taylor,65,64,47,176
S1011,Jerry Warren,11,69,30,110
S1012,Byron Post,19,50,40,109
S1013,Nathan Bush,50,31,71,152
S1014,Melissa Primm,12,0,82,94
S1015,George Bartos,10,64,65,139
S1016,Betty Randolph,90,36,27,153
S1017,Nicholas Mccann,59,38,86,183
S1018,Gary Foster,37,94,43,174
S1019,John Beckem,13,15,27,55
S1020,John Fisher,88,99,15,202
S1021,Marcy Blenman,93,34,96,223
S1022,Kent Morrison,27,11,21,59
S1023,John Aguirre,69,91,33,193
S1024,Joanna Shelton,53,73,73,199
S1025,Todd Morfin,97,66,39,202
S1026,Ruth Kaufman,69,49,63,181
S1027,Aisha Gardner,1,31,87,119
S1028,Vennie Cuevas,56,9,43,108
S1029,Donna Johnson,33,73,100,206
S1030,John Bauder,64,30,85,179
S1031,Carole Bishop,35,38,38,111
S1032,Abraham Snyder,46,70,94,210
S1033,Edward Avery,14,38,30,82
S1034,Timothy Harvey,64,80,37,181
S1035,Gregory Nitta,20,42,52,114
S1036,Jasmine Esters,78,64,34,176
S1037,Thomas Radley,95,32,48,175
S1038,Richard Hughes,20,15,82,117
S1039,Harold Morgan,65,9,7,81
S1040,Ana Adams,28,95,55,178
S1041,Olivia Bond,16,5,55,76
S1042,Agustin Monroy,20,25,32,77
S1043,Peter Urban,9,57,91,157
S1044,Warren Ray,85,66,82,233
S1045,Melissa Stallsworth,53,10,43,106
S1046,Elizabeth Newsome,74,14,3,91
S1047,Maria Mcallister,97,67,47,211
S1048,Rebecca Vida,53,35,39,127
S1049,Chris Benavides,31,20,54,105
S1050,Kyle Stanley,29,47,76,152
S1051,Dean Smith,91,76,20,187
S1052,Sharon Bergin,2,74,98,174
S1053,David Boatright,44,14,92,150
S1054,Lilly Overstreet,53,62,90,205
S1055,Faye Patrick,1,46,62,109
S1056,Michael Peatross,18,91,8,117
S1057,Joseph Heinemann,15,80,84,179
S1058,Lana Callan,69,69,97,235
S1059,Beverly Oshita,79,77,11,167
S1060,Patricia Allen,62,66,3,131
S1061,David Walters,0,98,87,185
S1062,Emily Butler,74,30,96,200
S1063,Donna Jefferson,48,88,91,227
S1064,Bessie Quinonez,97,77,47,221
S1065,David Simon,90,46,34,170
S1066,Albert Pace,64,95,38,197
S1067,Evelyn Scott,67,1,87,155
S1068,Joseph Blakemore,15,81,16,112
S1069,Agnes Dartez,0,49,93,142
S1070,Shannon Riseden,59,58,1,118
S1071,Amanda Wellman,90,67,32,189
S1072,Kevin Robles,19,66,31,116
S1073,Lisa Hewitt,38,99,100,237
S1074,Connie Denny,52,31,39,122
S1075,Ada Hausler,12,70,18,100
S1076,Melissa Miller,72,23,26,121
S1077,Lauren Holtsclaw,99,95,65,259
S1078,Mike Roose,28,61,50,139
S1079,Miguel Daly,6,3,4,13
S1080,Angela Daniels,68,49,0,117
S1081,Rufus Lanza,84,58,92,234
S1082,Kimberly Valentino,48,98,71,217
S1083,John Creed,37,75,50,162
S1084,Chris Moore,69,23,61,153
S1085,Paul Kendal,28,16,93,137
S1086,Eddie Ortiz,9,2,97,108
S1087,Edna Furlow,11,77,91,179
S1088,Brian Haggard,85,84,56,225
S1089,Darrell Lusher,47,31,39,117
S1090,Gisela Kennedy,5,42,74,121
S1091,Carole Lopez,49,88,76,213
S1092,Brian Myers,21,19,67,107
S1093,George Barron,54,78,18,150
S1094,Steven Dominguez,94,50,5,149
S1095,Melissa Wiley,50,14,19,83
S1096,Elizabeth Rogers,53,33,23,109
S1097,Brian Newman,72,66,0,138
S1098,Troy Ridenhour,93,6,57,156
S1099,Charles Shimmin,32,93,98,223
S1100,Aaron Omar,47,79,48,174
S1101,Rebecca Mcclung,56,98,89,243
S1102,Denise Carbone,50,77,89,216
S1103,Anthony Barajas,93,52,61,206
S1104,Lucille Odonell,17,93,75,185
S1105,Thelma Semmes,62,15,79,156
S1106,Patricia Bain,71,41,4,116
S1107,Dexter Lilly,60,68,24,152
S1108,Eric Blake,9,21,53,83
S1109,Jesse Numbers,2,47,38,87
S1110,Nancy Clay,58,19,14,91
S1111,Kelley Chan,10,13,55,78
S1112,Albert Cada,100,20,9,129
S1113,Lynne Myles,67,93,75,235
S1114,Jacob Mai,31,97,27,155
S1115,Darcy Sattler,36,84,9,129
S1116,Eva Staten,16,98,46,160
S1117,Ronald Schwartz,74,50,31,155
S1118,William Zuber,2,93,78,173
S1119,Lajuana Lehn,72,30,57,159
S1120,Alejandro Sartin,75,82,72,229
S1121,Latoya Cunningham,52,48,25,125
S1122,Daniel Hulslander,94,22,5,121
S1123,Nathan Renfro,95,75,91,261
S1124,Roger Horn,20,23,76,119
S1125,Carol Stamey,85,44,86,215
S1126,Stella Mccormick,3,0,49,52
S1127,Natalia Barrow,85,45,71,201
S1128,Judy Lopez,25,59,59,143
S1129,Heather Schwendinger,60,71,24,155
S1130,Emily Phillips,39,31,68,138
S1131,Charles Simpson,18,30,33,81
S1132,Mark Cole,52,96,5,153
S1133,Gina Urick,90,75,40,205
S1134,Arthur Hay,57,16,33,106
S1135,Kevin Beavers,50,66,89,205
S1136,Steven English,43,99,75,217
S1137,Holly Bauer,45,92,86,223
S1138,Donald Cook,39,68,26,133
S1139,Christopher Robinson,64,21,13,98
S1140,Leticia Hendley,68,87,44,199
S1141,Heidi Mraz,47,99,23,169
S1142,Judy Scuderi,90,55,67,212
S1143,Mirta Collins,33,25,88,146
S1144,Bobbie Hayden,41,29,87,157
S1145,Jeffrey Jordan,33,97,28,158
S1146,Robert Mattocks,47,97,5,149
S1147,Benny Perry,75,20,55,150
S1148,Patricia Jenkins,88,66,51,205
S1149,Wilson Luse,61,100,91,252
S1150,Linda Krouse,65,13,31,109
S1151,Rhonda Hernandez,96,71,49,216
S1152,Kristopher Martin,2,99,93,194
S1153,Karen Robertson,56,64,30,150
S1154,John Mosher,18,66,3,87
S1155,Logan Hambrick,49,74,91,214
S1156,Vicki Nett,94,36,2,132
S1157,Damon Goodwin,38,23,42,103
S1158,Patricia Mercedes,24,25,3,52
S1159,Adam Fink,48,94,98,240
S1160,Norman Stevens,66,64,48,178
S1161,Brian Krebs,23,56,93,172
S1162,Rose Mobilia,59,31,3,93
S1163,Luis Vanduzer,85,75,61,221
S1164,Curtis Vaughn,0,44,76,120
S1165,Wilfred Lahay,52,91,65,208
S1166,Mable Baker,95,34,21,150
S1167,Paul Jorgenson,19,28,74,121
S1168,Laura Crislip,44,89,68,201
S1169,Maria Scriven,66,5,28,99
S1170,Susan Howard,61,71,45,177
S1171,Thomas Hooper,41,73,65,179
S1172,Kimberly Shaw,4,10,32,46
S1173,Willard Gama,15,33,35,83
S1174,Beverly Bally,43,98,75,216
S1175,Alice Canevari,24,37,98,159
S1176,Robert Sanchez,46,45,13,104
S1177,Rose Crawford,30,41,37,108
S1178,Stephen Espada,3,3,58,64
S1179,Betty Nelson,84,53,37,174
S1180,Richard Hiller,5,65,5,75
S1181,Noah Guy,53,84,1,138
S1182,Socorro Sills,35,33,90,158
S1183,Jamie Snyder,8,63,44,115
S1184,Edward Raby,49,95,83,227
S1185,Frank Kelly,50,92,82,224
S1186,Juan Wilson,50,82,25,157
S1187,Helen Jacobson,64,2,77,143
S1188,Sylvester Mcnamara,90,66,25,181
S1189,Jared Brinkley,70,89,70,229
S1190,Loretta Burchell,65,38,55,158
S1191,Dixie Mullins,87,28,80,195
S1192,Anna Henderson,69,86,69,224
S1193,Robert Foxx,29,5,12,46
S1194,Kenneth Lawson,18,75,72,165
S1195,Sharon Michaels,90,77,19,186
S1196,Scott Guadalupe,60,69,5,134
S1197,Lorrie Juarez,62,87,50,199
S1198,John Boucher,45,10,35,90
S1199,Edgar Gomez,86,21,61,168
S1200,Barbra Perez,20,21,66,107
S1201,Jordan Carmichael,43,52,25,120
S1202,Barbara Padilla,61,5,95,161
S1203,Aja Daniel,14,87,8,109
S1204,Colby Rubens,69,64,34,167
S1205,Marjorie Palumbo,67,19,91,177
S1206,Angela Johnson,86,45,37,168
S1207,Sheila Alvarado,55,71,78,204
S1208,Richard Bronson,81,37,15,133
S1209,Susan Corcoran,29,24,54,107
S1210,Carmen Mendoza,46,35,12,93
S1211,Christine Samuel,35,67,89,191
S1212,Barbara Etsitty,55,27,29,111
S1213,Brian Montgomery,54,87,11,152
S1214,Todd Marquez,73,84,27,184
S1215,Alexis Raterman,100,75,75,250
S1216,Georgia Ulrich,7,82,42,131
S1217,Karen Carron,21,75,80,176
S1218,Emily Korn,46,90,71,207
S1219,Veronica Puma,90,74,52,216
S1220,Billie Langner,17,33,32,82
S1221,Fred Martinez,71,87,62,220
S1222,Beverley Blackmon,91,13,23,127
S1223,Hilda Mckenzie,43,2,16,61
S1224,Dorothy Hartley,25,69,51,145
S1225,Gregory Chamberlain,64,9,77,150
S1226,Catherine Escamilla,44,99,33,176
S1227,Matthew Heard,83,0,15,98
S1228,Janna Lilly,80,45,13,138
S1229,Barbara Samples,99,46,37,182
S1230,Dennis Carmichael,38,90,42,170
S1231,Garrett Steele,34,31,6,71
S1232,Jeffrey Matsumoto,17,91,79,187
S1233,Dorothy Mcalister,84,98,3,185
S1234,Ernest Taylor,87,46,35,168
S1235,Donald Pickhardt,88,66,62,216
S1236,Larry Komsthoeft,99,43,31,173
S1237,Richard Hodak,15,37,46,98
S1238,Christopher Gauze,96,38,25,159
S1239,Bernice Cox,33,50,8,91
S1240,Clark Russo,13,2,40,55
S1241,Steven Gabriel,28,96,25,149
S1242,Kevin Najera,96,52,95,243
S1243,Johnnie Crump,68,37,46,151
S1244,Mary Wagner,34,91,3,128
S1245,Jeffrey Green,73,85,20,178
S1246,Geoffrey Chatterton,39,11,53,103
S1247,Nancy Soto,33,44,31,108
S1248,Mitchell Byrne,60,57,22,139
S1249,Don Hoover,86,36,26,148
S1250,Edward Meginnes,31,31,70,132
S1251,Trent Wheeler,94,95,17,206
S1252,Ronald Garcia,77,66,19,162
S1253,Kyle Bennett,75,97,3,175
S1254,Shannon Choi,99,46,30,175
S1255,Cynthia Gillen,32,66,95,193
S1256,Ryan Harvey,66,33,35,134
S1257,Susan Phillips,76,87,99,262
S1258,Casandra Sonoda,90,89,15,194
S1259,Sharon Gilchrist,57,53,21,131
S1260,Cecil Pharr,84,53,95,232
S1261,Shirley Tomlin,98,14,13,125
S1262,James Cohen,84,86,43,213
S1263,Pedro Dillard,15,11,1,27
S1264,James Patterson,93,71,81,245
S1265,Douglas Thomson,9,9,88,106
S1266,Ashley Cottrill,99,25,48,172
S1267,Raymond Kennedy,6,40,5,51
S1268,Annika Leri,41,66,66,173
S1269,Jesus Starnes,58,17,88,163
S1270,Pamela Davis,78,70,2,150
S1271,Robert Rodriguez,74,95,38,207
S1272,Todd Varnado,61,98,93,252
S1273,Rita Chamblee,52,37,73,162
S1274,Kenneth Garcia,100,35,50,185
S1275,Angela Virkler,9,49,49,107
S1276,German Crosland,8,50,48,106
S1277,Janeen Johnson,11,39,16,66
S1278,Teresa Phillips,34,51,93,178
S1279,Patrick Quattlebaum,21,45,22,88
S1280,Carrie Cassano,26,41,5,72
S1281,Mary Engfer,99,71,5,175
S1282,Joe Elliot,56,13,83,152
S1283,John Ross,86,76,67,229
S1284,Erma Prado,0,91,69,160
S1285,Tammy Chastain,82,0,75,157
S1286,Mark Clift,87,5,38,130
S1287,Rebecca Adleman,94,41,15,150
S1288,Doris Mckeon,66,63,69,198
S1289,Helen Wooten,81,11,60,152
S1290,Timothy Pettner,41,87,82,210
S1291,Roberta London,74,43,94,211
S1292,Therese Lofquist,28,32,37,97
S1293,Robert Savell,71,31,36,138
S1294,Wilfred Simonton,57,30,3,90
S1295,Hugo Symes,35,19,74,128
S1296,Leon Birnbaum,25,40,88,153
S1297,Herbert Morabito,34,64,46,144
S1298,Jeanette Glass,74,47,61,182
S1299,Thomas Crutchfield,9,46,69,124
S1300,Steve Leech,66,82,81,229
S1301,Serafina Leija,37,21,49,107
S1302,Lanny Quadnau,18,45,100,163
S1303,Tammy Brookskennedy,47,33,16,96
S1304,Kristen Hailey,32,12,60,104
S1305,Rodger Connelly,57,42,69,168
S1306,Darrell Rivera,92,2,97,191
S1307,Todd Miner,13,89,77,179
S1308,Sarah Steege,53,91,89,233
S1309,Eleanor Maddrey,73,4,81,158
S1310,Phil Jennings,53,60,15,128
S1311,Martha Williams,76,58,63,197
S1312,Betty Iliff,70,75,52,197
S1313,Naomi Bolin,75,15,98,188
S1314,Michael Benson,62,49,53,164
S1315,Charles Swift,9,17,63,89
S1316,Blanca Gupta,92,19,49,160
S1317,William Leavitt,25,57,7,89
S1318,Jennifer Larson,34,39,71,144
S1319,Peter Bynum,20,65,21,106
S1320,Bryan Dudley,93,44,10,147
S1321,Elizabeth Escamilla,51,46,43,140
S1322,Dustin Hodges,47,12,18,77
S1323,Michael Crews,70,38,46,154
S1324,Barbara Wilson,4,21,81,106
S1325,Mamie Peoples,59,63,26,148
S1326,Jon Borders,6,67,67,140
S1327,Jason Mcilvain,46,90,8,144
S1328,Jason Sisk,84,8,45,137
S1329,Ross Mosley,34,9,8,51
S1330,Mary Martin,42,64,0,106
S1331,Jeri Wells,43,13,87,143
S1332,Jenny Sansom,25,5,28,58
S1333,Ashley Anglea,38,78,62,178
S1334,John Perez,54,68,93,215
S1335,Michele Mitchell,88,42,27,157
S1336,Jose Morris,93,55,54,202
S1337,Virgilio Gordan,51,16,16,83
S1338,Brandon Allen,87,0,93,180
S1339,Miguel Oakley,1,72,26,99
S1340,Carmen Ellenberger,14,49,87,150
S1341,Richard Geisler,99,3,49,151
S1342,Sarah Nelson,2,77,69,148
S1343,Tim Peterson,59,75,81,215
S1344,John Seaberry,51,7,14,72
S1345,Stanley Holbrook,35,78,53,166
S1346,Kelvin Nixon,50,19,96,165
S1347,Charles Lockwood,47,66,93,206
S1348,Robert Umana,2,33,40,75
S1349,Dora Kean,47,69,62,178
S1350,Deborah Port,13,87,70,170
S1351,Sonya Klingenberg,66,88,10,164
S1352,Lettie Claybrook,83,41,24,148
S1353,David Evans,13,12,11,36
S1354,Prudence Butler,34,23,41,98
S1355,Agnes Reynolds,82,47,24,153
S1356,Isaac Holling,96,26,2,124
S1357,Cyril Marquez,1,11,68,80
S1358,Amy Vanzee,19,20,60,99
S1359,Harold White,81,67,28,176
S1360,Bernard Hillian,29,22,52,103
S1361,James Beighley,99,73,100,272
S1362,Peter Marien,26,4,90,120
S1363,Mary Wilson,65,49,95,209
S1364,Susan Hirsch,53,68,21,142
S1365,Jason Westgate,6,42,46,94
S1366,Clara Courtney,49,16,38,103
S1367,Frances Oliverio,17,37,33,87
S1368,Dale Otsuka,56,56,67,179
S1369,Mary Plateroti,93,11,39,143
S1370,Kindra Poirier,39,40,63,142
S1371,Joseph Foote,76,87,47,210
S1372,Linda Day,39,95,62,196
S1373,Anna Buzby,27,67,39,133
S1374,Robby Parker,8,92,39,139
S1375,Matthew Gray,62,91,5,158
S1376,Walter Donelson,18,30,42,90
S1377,Carolyn Smith,60,92,66,218
S1378,Kim Green,97,25,81,203
S1379,Tambra Fields,34,57,57,148
S1380,Christopher Thompson,74,1,11,86
S1381,Patricia Bell,13,33,75,121
S1382,Lisa Nguyen,24,4,47,75
S1383,Zachary Pollina,89,76,89,254
S1384,Aaron Hughes,23,38,56,117
S1385,Mary Beahm,72,83,12,167
S1386,Ana Stephens,47,80,68,195
S1387,Mary Macnaught,37,42,11,90
S1388,Elizabeth Kint,56,100,59,215
S1389,Richard Mayer,85,56,63,204
S1390,Carol Cherry,25,93,68,186
S1391,Mable Dodson,27,9,48,84
S1392,Terrence Frierson,70,44,84,198
S1393,Bobby Washburn,52,43,67,162
S1394,Michael Evans,87,22,93,202
S1395,Charles Peppers,92,5,85,182
S1396,Young Vickers,0,52,74,126
S1397,Zachary Hanson,78,17,44,139
S1398,Barry Grose,78,29,57,164
S1399,Pedro Grimes,14,35,17,66
S1400,Martha Ancheta,42,25,73,140
S1401,Marie Bolding,89,22,70,181
S1402,Danielle Nava,95,94,18,207
S1403,Eddie Witmer,40,23,28,91
S1404,Samuel Barrett,96,73,70,239
S1405,Quyen Brumfield,69,52,76,197
S1406,William Wilson,98,64,32,194
S1407,Robert Weir,55,57,0,112
S1408,Mike Kelly,51,82,32,165
S1409,Kelly Ridlon,68,18,45,131
S1410,Star Mudd,74,62,4,140
S1411,Edward Cuevas,40,61,71,172
S1412,Joan Manthe,96,83,91,270
S1413,Melvin Atkins,14,0,90,104
S1414,Thomas Sumney,25,54,53,132
S1415,Delores Farr,70,14,86,170
S1416,Sally Brown,51,39,80,170
S1417,Thomas Hertenstein,2,34,3,39
S1418,Candace Hosler,0,52,3,55
S1419,Michael Potter,89,52,89,230
S1420,Shaun Knoblock,18,65,31,114
S1421,Francisco Brookshire,60,14,28,102
S1422,Della Zobel,52,77,13,142
S1423,Rosemary Parkhurst,14,10,76,100
S1424,Robert Renteria,100,90,68,258
S1425,So Phillips,60,91,84,235
S1426,Phyllis Ross,22,70,22,114
S1427,Malika Wolfe,33,12,9,54
S1428,Kristina Weatherly,55,68,81,204
S1429,Larry Daniel,92,53,52,197
S1430,Iliana Higbee,80,86,37,203
S1431,Delia Urie,49,79,96,224
S1432,Eddie Cummings,75,66,20,161
S1433,Johnny Wright,38,79,35,152
S1434,Bud Christofferso,68,36,66,170
S1435,Jacqueline Nelson,3,82,93,178
S1436,Rena Laub,82,72,33,187
S1437,Willie Owens,43,78,90,211
S1438,Mary Rackham,60,2,18,80
S1439,Thomas Pless,36,24,11,71
S1440,Clara Saraiva,41,90,76,207
S1441,John Kiley,70,96,64,230
S1442,Claire Scott,11,4,86,101
S1443,William Golden,81,15,64,160
S1444,Ruth Rosales,37,85,52,174
S1445,Vincent Shepherd,36,11,91,138
S1446,Russell Lynn,79,55,25,159
S1447,Miguel Aste,92,59,38,189
S1448,Sylvia Mathis,96,64,62,222
S1449,Larry Witzke,56,39,80,175
S1450,Gloria Kimbrough,32,61,17,110
S1451,Joshua Garland,11,38,89,138
S1452,Tami Adams,63,77,53,193
S1453,Ruth Thompson,9,98,13,120
S1454,Ruth Albritton,58,37,82,177
S1455,Christopher Wolter,85,28,19,132
S1456,Norma Williams,50,11,52,113
S1457,Esther Bishop,53,43,33,129
S1458,Kerry Butler,97,45,20,162
S1459,Amanda Kostura,35,10,52,97
S1460,Cherise Ray,72,24,16,112
S1461,Jose Little,49,31,45,125
S1462,William Trujillo,63,83,79,225
S1463,Gladys Wolf,30,48,85,163
S1464,Agnes Edwards,32,1,60,93
S1465,Casey Padovano,44,20,43,107
S1466,Ella Molina,59,37,54,150
S1467,Marie Hersey,83,42,5,130
S1468,Earl Driscoll,31,17,35,83
S1469,Clifford West,52,73,96,221
S1470,Amado Adams,47,22,2,71
S1471,Norma Jones,92,49,69,210
S1472,Tony Tucker,23,2,10,35
S1473,Melinda Hostetler,42,8,7,57
S1474,Michael Bennett,63,4,92,159
S1475,Virginia Lucero,41,59,93,193
S1476,Matthew Abbott,29,14,61,104
S1477,Alfred Ellison,60,89,66,215
S1478,Margie Rothman,86,76,27,189
S1479,Robyn Harris,18,94,93,205
S1480,Robert Keaton,25,21,13,59
S1481,John Macquarrie,66,8,42,116
S1482,Max Ford,7,79,25,111
S1483,Earnest Cournoyer,6,69,15,90
S1484,Zachary Mckoy,35,87,58,180
S1485,Lorrine Gonzalez,26,82,13,121
S1486,Jason Qualls,39,89,26,154
S1487,Lillian Mercado,30,62,20,112
S1488,Alison Samaroo,94,1,4,99
S1489,Vincent Foulk,15,32,5,52
S1490,Christine Oquendo,27,22,9,58
S1491,Eddie Younger,81,72,65,218
S1492,Lori Garcia,99,79,70,248
S1493,Greg Holbert,86,88,66,240
S1494,Tod Smith,22,14,31,67
S1495,Tina Parr,16,19,0,35
S1496,Cynthia Hannan,27,9,68,104
S1497,Jenna Benedetto,45,76,90,211
S1498,Walter Jolly,28,88,0,116
S1499,Heidi Jenks,93,37,19,149
S1500,Phyllis Cook,92,94,20,206
S1501,Julia Enlow,46,30,37,113
S1502,Fred Buford,5,91,80,176
S1503,Linda Sawtelle,4,65,43,112
S1504,Jimmy Love,27,45,94,166
S1505,James Shawl,28,83,33,144
S1506,Louis Carr,16,58,71,145
S1507,Monica Burchess,42,15,5,62
S1508,Charles Swendsen,4,92,75,171
S1509,Russell Nigro,51,56,27,134
S1510,April Ammon,54,85,92,231
S1511,Evangeline Daniels,57,52,53,162
S1512,Luther Krier,10,25,54,89
S1513,Joseph Armstrong,29,75,96,200
S1514,Wanda Mcdaniel,67,99,95,261
S1515,John Whitman,90,15,98,203
S1516,Elaine Stoker,81,22,70,173
S1517,John Hale,9,5,7,21
S1518,Jeff Conway,62,38,6,106
S1519,James Jeronimo,24,4,29,57
S1520,Albert Andreozzi,52,98,73,223
S1521,Ann Gordy,26,0,100,126
S1522,Marie Goods,79,52,64,195
S1523,Pearl Mattione,49,82,86,217
S1524,Karen Cardillo,52,66,40,158
S1525,Janet Anello,23,5,97,125
S1526,Christine Mester,52,3,87,142
S1527,Darren Sakai,55,95,45,195
S1528,Elmer Forth,25,57,29,111
S1529,Kerri Broussard,39,91,68,198
S1530,Blossom Smith,72,54,15,141
S1531,Kam Paradise,82,29,13,124
S1532,Harold Thornton,69,61,56,186
S1533,Sharon Jageman,17,98,35,150
S1534,Lauren Grose,12,42,22,76
S1535,Anita Gwaltney,0,39,69,108
S1536,Robert Ballard,14,17,55,86
S1537,Brenda Wilson,19,32,69,120
S1538,Ashley Barry,84,39,53,176
S1539,Kevin Mccloskey,68,95,91,254
S1540,Isabel Gregory,5,52,82,139
S1541,Wayne Brothers,73,1,27,101
S1542,David Woods,73,36,27,136
S1543,Rebecca Conner,36,28,1,65
S1544,Mary Gonzales,90,4,60,154
S1545,William Bullard,81,47,96,224
S1546,Sean Melendy,63,71,48,182
S1547,Virginia Martin,86,11,95,192
S1548,Lonnie Mitchell,73,93,29,195
S1549,Sarah Woody,38,75,45,158
S1550,Constance Starrett,93,6,54,153
S1551,Philip Woolfolk,84,53,94,231
S1552,Ruth Bishop,17,87,90,194
S1553,Kimberly Smith,3,62,1,66
S1554,Kimberly Villarreal,0,46,89,135
S1555,Lisa Unrein,42,18,32,92
S1556,Robert Dang,73,13,28,114
S1557,John Herrin,88,15,86,189
S1558,James Lewis,81,2,89,172
S1559,Porter Burns,13,74,65,152
S1560,Bethany Bartley,3,2,15,20
S1561,Son Brewer,7,37,15,59
S1562,Yvette Bell,37,46,47,130
S1563,Krystyna Chau,71,63,52,186
S1564,Stephanie Arroyo,81,93,8,182
S1565,Barbara Sullivan,47,18,93,158
S1566,June Wood,96,95,75,266
S1567,Virginia Lovelady,71,96,44,211
S1568,Tamara Whitrock,38,96,48,182
S1569,Diane Hathaway,83,82,71,236
S1570,Anthony Bitter,10,76,53,139
S1571,Patricia Farmer,85,49,81,215
S1572,Henry Hudgens,51,8,59,118
S1573,Roxie Schwartz,64,19,87,170
S1574,Peter Tufts,47,90,69,206
S1575,Jody Tyrrell,13,25,54,92
S1576,Brenda Herrara,79,27,82,188
S1577,Curtis Parker,88,23,74,185
S1578,Justin Mcevoy,0,59,46,105
S1579,Christine Christopherso,30,11,95,136
S1580,Tammy Raymond,51,58,5,114
S1581,Clifford Everett,29,9,72,110
S1582,Johnathan Marinelli,52,91,99,242
S1583,Trevor Hooper,50,18,44,112
S1584,Leslie Holmes,12,97,38,147
S1585,Alma Marty,3,40,73,116
S1586,Susan Johnson,0,21,81,102
S1587,James Belkowski,77,72,96,245
S1588,James Davis,76,85,59,220
S1589,Rosa Martin,78,3,89,170
S1590,Tammie Withers,88,25,20,133
S1591,Ernestine Nopper,21,81,36,138
S1592,Rayford Garrick,95,73,82,250
S1593,Sharon Cardenas,69,87,55,211
S1594,Contessa Moss,11,79,69,159
S1595,Patricia Scott,82,12,71,165
S1596,Randy Heyd,18,90,67,175
S1597,Gilbert Caskey,28,29,21,78
S1598,Karen Crow,60,10,100,170
S1599,Willie Shellenbarger,39,9,54,102
S1600,Barry Elliott,40,26,24,90
S1601,Ashley Hegg,69,82,40,191
S1602,Willie Schreck,1,58,7,66
S1603,Steven Potts,26,91,14,131
S1604,Ruth Adams,73,79,72,224
S1605,Leigh Clark,15,39,24,78
S1606,Mary Joubert,81,24,89,194
S1607,Jeanette Elliott,13,93,95,201
S1608,Jasmine Iverson,30,84,38,152
S1609,Mable Glisson,83,68,80,231
S1610,Loretta Kaeo,81,51,78,210
S1611,Devon Dennis,43,83,58,184
S1612,George Lay,96,77,88,261
S1613,Ralph Miller,45,22,4,71
S1614,Arthur Micciche,92,51,13,156
S1615,Sylvester Elder,65,0,3,68
S1616,Harold Mills,25,27,63,115
S1617,Robert Cobb,58,88,25,171
S1618,Brenda Sparks,99,79,17,195
S1619,Joe Klinger,34,1,3,38
S1620,Nancy Keller,52,63,93,208
S1621,Tamie Figaro,28,70,14,112
S1622,Esther Cacy,1,50,68,119
S1623,Pearl Melcher,42,18,43,103
S1624,Regina Engelken,96,26,6,128
S1625,Luis Takemura,83,44,86,213
S1626,Carol Ferris,52,48,98,198
S1627,Elwood Wrape,87,90,33,210
S1628,Steven Mora,59,84,23,166
S1629,Linda Slawson,26,84,87,197
S1630,Edna Montoya,51,89,19,159
S1631,Richard Lord,54,23,8,85
S1632,Ann Stevens,65,11,78,154
S1633,Amanda Thompson,0,54,31,85
S1634,Cindy Shaffer,69,29,52,150
S1635,Jennifer Maynard,14,0,41,55
S1636,Christopher Hoefling,79,98,52,229
S1637,Edna Lugo,11,87,65,163
S1638,Rosa Bond,46,26,92,164
S1639,Bruce Davis,0,63,50,113
S1640,Linda Boris,87,66,3,156
S1641,Kathy Devereux,0,47,94,141
S1642,Tyler Campbell,81,72,25,178
S1643,Virginia Nagata,30,7,96,133
S1644,Sheryl Owen,7,77,13,97
S1645,Nicholas Peterson,75,25,78,178
S1646,Andrea Landgraf,63,1,90,154
S1647,Paul Neubauer,80,74,54,208
S1648,Elsa Robbins,31,22,60,113
S1649,Steve Morgan,39,96,100,235
S1650,John Winstead,53,44,95,192
S1651,Angeline Gibson,66,96,99,261
S1652,John Whisenant,17,98,46,161
S1653,Elizabeth Hammond,19,64,14,97
S1654,Craig Joshua,96,99,76,271
S1655,Latanya Duncan,39,52,27,118
S1656,David Richards,19,100,77,196
S1657,Anton Rooks,76,100,64,240
S1658,Willard Diaz,76,38,59,173
S1659,Lawrence Vinson,19,5,14,38
S1660,Larry Fleming,95,98,38,231
S1661,Pamela Andrews,36,14,83,133
S1662,Shawn Marlow,17,53,13,83
S1663,Elizabeth Everhart,77,67,70,214
S1664,Ashley Ballard,18,65,52,135
S1665,Myrtle Moore,59,23,79,161
S1666,Barry Williams,71,68,37,176
S1667,Kathryn Potter,86,2,61,149
S1668,Verline George,59,96,18,173
S1669,Suzanne Dawson,73,71,87,231
S1670,Barbara Ellison,75,62,83,220
S1671,Andrea Ricks,97,67,24,188
S1672,Vera Clegg,39,27,63,129
S1673,Janice Kennerly,2,35,25,62
S1674,Nicholas Roberson,13,6,25,44
S1675,Billy Munoz,22,53,61,136
S1676,Michelle Perkins,71,41,2,114
S1677,Barbara Lyon,97,7,35,139
S1678,June Bailey,53,45,6,104
S1679,Diana Selley,27,3,17,47
S1680,Mary Eisenberg,41,8,63,112
S1681,John Stamps,73,95,48,216
S1682,Mitchell Williams,89,22,18,129
S1683,Mariano Morris,28,18,39,85
S1684,Helen Lounsbury,7,38,54,99
S1685,William Brock,83,16,71,170
S1686,Becky Casey,52,0,4,56
S1687,Bradley Mccoy,49,62,12,123
S1688,James Anderson,99,99,70,268
S1689,Hugh Hurd,82,8,5,95
S1690,Victor Jones,7,87,16,110
S1691,Edwin Malmin,56,60,4,120
S1692,Teresa Velez,80,4,98,182
S1693,Justin Padgett,68,66,32,166
S1694,Ronald Lanasa,18,31,0,49
S1695,Rene Lauer,24,9,73,106
S1696,Dennis Colunga,49,57,74,180
S1697,Christopher Turney,99,19,40,158
S1698,Norma Lewis,36,2,72,110
S1699,Clifford Field,62,56,88,206
S1700,William Vance,24,6,87,117
S1701,Peggy Mcdaniel,44,2,61,107
S1702,Walter Mcnear,63,60,47,170
S1703,Cynthia Martinez,49,29,22,100
S1704,Jeffrey Tourville,79,76,94,249
S1705,Sandy Jackson,88,40,16,144
S1706,Terrence Ellsworth,55,29,19,103
S1707,Blanca Koch,77,75,82,234
S1708,Daniel Uelmen,3,76,56,135
S1709,Alvera Jones,28,52,92,172
S1710,Richard Wilcox,22,28,76,126
S1711,John Lucas,48,88,86,222
S1712,Nicole Britton,42,59,58,159
S1713,William Weiner,11,11,30,52
S1714,Robert Yepes,12,94,83,189
S1715,Elva Johnson,96,42,61,199
S1716,Ima Tourville,55,85,18,158
S1717,Samuel Perez,43,4,37,84
S1718,John Akins,22,90,4,116
S1719,Phillip Lomax,52,22,56,130
S1720,Estelle Sloan,100,9,28,137
S1721,Louis Osborn,36,97,65,198
S1722,Kevin Peck,57,12,90,159
S1723,Jessie Seigler,41,73,8,122
S1724,Lori Thomas,4,81,48,133
S1725,Samuel Finnegan,21,38,33,92
S1726,Bonita Cowger,8,60,25,93
S1727,Dawn Pellegrini,29,51,92,172
S1728,Kathryn Olmeda,57,36,27,120
S1729,Cindy Trombly,19,48,94,161
S1730,Marcia Soto,77,60,66,203
S1731,Cory Sprenkle,46,45,9,100
S1732,Maria Phillips,100,52,98,250
S1733,Linda Aycock,71,22,87,180
S1734,Karen Wanty,59,93,29,181
S1735,Michael Householder,66,91,4,161
S1736,Gerard Hernandez,92,50,57,199
S1737,Virginia Beck,97,71,2,170
S1738,Scott Janes,74,43,35,152
S1739,Patricia Swanson,69,78,0,147
S1740,Barbara Salazar,96,28,12,136
S1741,Edward Nelson,61,8,18,87
S1742,Ivan Shapiro,25,95,73,193
S1743,Kelsey Gay,28,48,55,131
S1744,Billy Chavis,64,51,73,188
S1745,Aaron Moss,67,98,72,237
S1746,Kenneth Kirkland,68,4,75,147
S1747,Cynthia Durgin,18,9,2,29
S1748,Betty Wilson,38,98,57,193
S1749,Kathleen Kelly,45,16,72,133
S1750,Tyler Sanville,42,80,70,192
S1751,Joel Brafman,19,3,44,66
S1752,Meagan Mcdavid,50,42,100,192
S1753,Wayne Sawyer,40,28,90,158
S1754,Jay Graham,14,46,50,110
S1755,Apolonia Vicente,83,67,84,234
S1756,Richard Everett,65,69,34,168
S1757,Seth Hunstad,6,83,53,142
S1758,Bob Hughes,11,36,25,72
S1759,Michael Yeh,10,12,67,89
S1760,Tyson Fredrickson,62,57,63,182
S1761,Christopher Baylor,33,19,4,56
S1762,Yolanda Barrett,92,56,89,237
S1763,Willie Berrier,18,78,45,141
S1764,Stephen Roberson,96,32,64,192
S1765,Barbara Reid,22,53,18,93
S1766,Bessie Jones,0,100,80,180
S1767,James Bailly,19,43,36,98
S1768,Mark Muse,22,66,78,166
S1769,Jamie Schneeman,48,17,72,137
S1770,Edmundo Larson,25,85,74,184
S1771,Albert Beaver,53,68,66,187
S1772,Shannon Messer,77,83,89,249
S1773,Jacquelyn Lance,70,77,34,181
S1774,Lois Tate,50,77,40,167
S1775,Megan Chambers,43,56,4,103
S1776,Rebekah Riley,91,54,80,225
S1777,Kristopher Selfridge,10,46,80,136
S1778,Barbara Stewart,20,55,85,160
S1779,Scott Hamilton,43,18,90,151
S1780,Wallace Baker,76,33,21,130
S1781,Jerri Coleman,75,51,39,165
S1782,Rosario Wright,81,14,59,154
S1783,Heather Sibrel,62,54,62,178
S1784,Lillian Tyson,38,64,74,176
S1785,Stacy Rago,45,87,62,194
S1786,Harry Buchholtz,0,38,6,44
S1787,Lawrence Mcgarry,68,73,34,175
S1788,Donna Maxwell,47,55,85,187
S1789,Richard Powers,83,3,86,172
S1790,Henry Lilley,51,77,3,131
S1791,Elizabeth Fletcher,76,5,80,161
S1792,Luis Sewell,95,57,75,227
S1793,Lynette Ealey,93,84,63,240
S1794,Jeffrey Gaitor,61,50,92,203
S1795,Eugenio Yu,4,86,65,155
S1796,Amy Palumbo,67,32,69,168
S1797,Greg Gillaspie,24,80,18,122
S1798,Fannie Mitchell,1,71,28,100
S1799,Matt Ruiz,26,72,99,197
S1800,Bobby Sigg,52,66,96,214
S1801,Alan Edmonds,37,63,50,150
S1802,Samuel Krulik,56,65,42,163
S1803,James Jiron,2,74,29,105
S1804,Jaclyn Melvin,34,9,39,82
S1805,Melissa Kafer,51,76,26,153
S1806,Denise Wilcox,7,61,20,88
S1807,Raymond Johnston,52,5,4,61
S1808,Jose West,23,21,93,137
S1809,Susan Reeves,22,28,43,93
S1810,Dorothy Hallam,62,38,18,118
S1811,Debrah Spry,95,87,28,210
S1812,Danny Fagen,26,31,76,133
S1813,Amanda Fendley,29,45,67,141
S1814,Leila Evans,46,96,87,229
S1815,Jeannine Murray,39,3,35,77
S1816,Mary Abdi,71,91,28,190
S1817,Judith Jefferson,74,42,14,130
S1818,Robert Song,2,57,11,70
S1819,Mary Jones,12,5,20,37
S1820,Mark Petterson,10,9,20,39
S1821,Arturo Cray,81,43,76,200
S1822,Angela Tanguay,99,89,14,202
S1823,Harry Duval,26,36,38,100
S1824,Angela Garrett,27,86,7,120
S1825,Loyd Navarez,63,58,42,163
S1826,Denise Slocum,82,15,74,171
S1827,Michele Francis,62,49,75,186
S1828,Wanda Mohr,48,44,73,165
S1829,Roy Weaver,59,64,42,165
S1830,Matthew Thomas,78,28,54,160
S1831,Tracy Sagedahl,17,13,15,45
S1832,Dale Robinson,64,88,24,176
S1833,Lisa Sholar,79,85,77,241
S1834,Jennifer Jones,77,12,60,149
S1835,Kathryn Yarmitsky,35,4,21,60
S1836,James Johnson,95,55,49,199
S1837,Henry Luna,0,65,42,107
S1838,Harry Miller,81,48,40,169
S1839,Louise Weiss,97,26,84,207
S1840,Shannon Brown,29,12,91,132
S1841,Milton Hammond,32,20,72,124
S1842,Richard Bartels,39,39,92,170
S1843,Leon Baron,1,15,92,108
S1844,Paul Hess,24,63,9,96
S1845,Richard Moore,30,22,13,65
S1846,Victor Goulding,96,34,94,224
S1847,Tina Rich,29,87,43,159
S1848,Christine Schroeder,1,17,78,96
S1849,Crystal Elliott,22,39,43,104
S1850,Joanna Ryan,27,14,55,96
S1851,William Bell,100,27,24,151
S1852,Martha Calzada,10,31,96,137
S1853,Paul Morgan,5,16,42,63
S1854,Sally Little,57,0,96,153
S1855,Matthew Dong,14,9,35,58
S1856,Carrie Murphy,45,85,53,183
S1857,Ronald Camacho,34,72,77,183
S1858,Douglas Redding,18,33,44,95
S1859,Jody Ferguson,81,0,57,138
S1860,Leon Ramirez,42,48,3,93
S1861,Janna Jurado,14,85,58,157
S1862,Joe Sandstrom,79,62,41,182
S1863,James Bischoff,23,68,76,167
S1864,Brian Knutson,32,29,54,115
S1865,Shawnee Flores,71,74,82,227
S1866,Berniece Jones,78,57,90,225
S1867,Betty Stevenson,76,41,98,215
S1868,Connie Moss,75,21,97,193
S1869,Dennis Bentley,69,32,99,200
S1870,Al Ham,85,78,29,192
S1871,Gregg Reaves,65,28,8,101
S1872,Donna Gaynor,38,47,13,98
S1873,Glen Harness,52,57,48,157
S1874,Lula Lu,52,25,89,166
S1875,Amy Gonzales,53,65,68,186
S1876,Edith Powell,12,59,87,158
S1877,Esther Frese,13,26,69,108
S1878,Kelley Krys,9,59,92,160
S1879,Williams Armon,1,75,70,146
S1880,Petra Harrod,77,73,93,243
S1881,Clinton Reilly,32,1,77,110
S1882,Jimmy Patterson,18,85,92,195
S1883,Richard Vega,32,8,51,91
S1884,Greg Kimball,70,65,64,199
S1885,Joan Crafton,20,63,21,104
S1886,Mary Higgins,98,72,6,176
S1887,Mario Hanson,12,73,62,147
S1888,Lloyd Brinkman,71,87,70,228
S1889,Gregorio Queen,53,15,99,167
S1890,Darrell May,49,100,84,233
S1891,Betty Munguia,77,89,86,252
S1892,Scott Kincaid,66,14,40,120
S1893,Richie Hysell,24,27,6,57
S1894,Matthew Rees,6,13,7,26
S1895,Barbara Montgomery,36,93,8,137
S1896,Edward Stratton,44,69,62,175
S1897,Melissa Blackburn,44,17,33,94
S1898,Antonio Vanderlinde,69,12,93,174
S1899,Jenifer Smith,80,44,98,222
S1900,William Shifflett,61,89,80,230
S1901,Donna Proffitt,97,33,40,170
S1902,Jamie Evans,82,31,58,171
S1903,Vickie Graves,59,8,48,115
S1904,Melissa Pierce,63,52,97,212
S1905,Miriam Seymore,79,53,69,201
S1906,Christopher Chapman,15,26,90,131
S1907,David Ball,40,31,11,82
S1908,Sara Steele,21,31,27,79
S1909,Steven Boykin,65,14,71,150
S1910,Esther White,27,66,3,96
S1911,Daniel Smith,22,38,18,78
S1912,Mary Horne,80,38,69,187
S1913,Stephen Weatherly,99,55,9,163
S1914,Mary Tarver,52,30,0,82
S1915,Davis Mcquay,26,72,10,108
S1916,Conrad Gallagher,6,79,99,184
S1917,Irene Brenna,14,16,0,30
S1918,Verna Adams,60,23,3,86
S1919,Leslie Giles,94,62,17,173
S1920,Nicole Silveira,63,80,19,162
S1921,William Marquez,23,86,68,177
S1922,Cynthia Armstead,20,32,46,98
S1923,Margaret Beam,78,10,69,157
S1924,Melvin Shaw,6,71,41,118
S1925,Star Hughes,11,2,78,91
S1926,Irene Martinez,93,32,67,192
S1927,Alma Anderson,78,40,17,135
S1928,Phyllis Larson,62,62,72,196
S1929,Ricardo Cerda,37,81,99,217
S1930,Gene Robinson,8,2,90,100
S1931,Vernon Hardy,95,96,11,202
S1932,Ariana Pagan,95,70,74,239
S1933,Kathryn Gonzalez,38,48,64,150
S1934,James Woods,97,50,56,203
S1935,Patty Belden,12,12,13,37
S1936,Jim Reese,43,19,81,143
S1937,Kayla Edwards,20,11,97,128
S1938,Cynthia Faiella,24,86,7,117
S1939,Debra Wright,72,70,33,175
S1940,William Maranda,72,73,84,229
S1941,Henry Whittington,0,82,42,124
S1942,Kimberly Demaria,70,11,8,89
S1943,Anthony Smith,51,1,13,65
S1944,Kayce Sharp,23,40,69,132
S1945,Frank Lowe,68,90,55,213
S1946,Robert Elias,75,34,34,143
S1947,Michelle Zunich,59,71,14,144
S1948,Mary Shields,4,49,62,115
S1949,Lily Holiday,72,68,67,207
S1950,Priscilla Coffey,67,77,55,199
S1951,Melissa Blackwell,94,17,86,197
S1952,Janet Kuhns,95,96,48,239
S1953,Alphonse Tolbert,32,39,4,75
S1954,Matthew Allen,83,92,96,271
S1955,Jesenia Watson,60,1,32,93
S1956,Marissa Love,100,86,27,213
S1957,John Morales,7,60,31,98
S1958,Ida Garcia,99,50,38,187
S1959,Iris Dahl,37,26,21,84
S1960,Michael Fisher,29,56,53,138
S1961,Elizabeth Berg,3,64,92,159
S1962,Frank Lockhart,30,44,99,173
S1963,Nancy Fry,63,16,17,96
S1964,Arthur Mortenson,85,79,63,227
S1965,Oscar Phifer,79,57,51,187
S1966,William Brashear,11,55,89,155
S1967,Suzanne Mance,54,27,54,135
S1968,James Davidson,91,79,77,247
S1969,Alfonso Dansie,20,60,54,134
S1970,Jimmy Tillman,83,94,53,230
S1971,Kristin Stanton,76,87,83,246
S1972,Fernando Dobratz,96,44,89,229
S1973,Ruth Fallon,81,43,25,149
S1974,Margaret Woods,11,4,76,91
S1975,Sandra Martinez,25,61,30,116
S1976,Monique Mallett,9,17,6,32
S1977,Jesus Salgado,93,68,50,211
S1978,Stevie Mcardle,100,80,68,248
S1979,Brandon Trinidad,79,14,80,173
S1980,Stephanie Crook,84,94,23,201
S1981,Kathryn Sandifer,82,41,9,132
S1982,Suzanne Litteral,58,94,60,212
S1983,John Schaunaman,37,22,14,73
S1984,Mary Reed,68,19,8,95
S1985,Irene Esposito,92,60,89,241
S1986,Minerva Hogan,50,59,95,204
S1987,Sarah May,46,37,28,111
S1988,Tommy Hartfield,91,2,83,176
S1989,Shawn Smith,44,24,33,101
S1990,Jaime William,79,51,85,215
S1991,Robbin Thurston,42,4,35,81
S1992,Dale Williams,61,24,24,109
S1993,Raven Gossard,19,29,83,131
S1994,Mary Young,90,39,42,171
S1995,Lucy Gibson,6,85,81,172
S1996,Susan Herron,96,74,60,230
S1997,Mike Ladd,8,51,79,138
S1998,Marie Fox,79,48,95,222
S1999,Clinton Scott,97,77,5,179
S2000,Clifford Gonzalez,4,31,68,103
S2001,Michael Holloway,50,86,21,157
S2002,Jesse Rodriguez,63,38,21,122
S2003,Timothy Montijo,40,92,67,199
S2004,Raye Leach,68,72,25,165
S2005,Andrew Escoto,95,56,22,173
S2006,Dorothy Murphy,74,20,64,158
S2007,Frances Mceachran,82,72,45,199
S2008,Stephen Gall,43,5,87,135
S2009,Bob Bennett,64,45,35,144
S2010,Harold Dupas,48,89,10,147
S2011,Douglas Izatt,36,4,73,113
S2012,Robert Colon,16,13,23,52
S2013,Mary Castillo,76,91,14,181
S2014,Carol Diaz,52,6,79,137
S2015,Albert Hoston,61,4,66,131
S2016,Julius Hawley,58,100,54,212
S2017,Timothy Quintana,1,98,1,100
S2018,Jess Siciliano,98,62,46,206
S2019,Harry Lashley,37,71,33,141
S2020,Kathleen Baker,68,81,18,167
S2021,Erasmo Welch,31,73,39,143
S2022,Theresa Gondek,20,26,43,89
S2023,Elisa Patrylak,35,84,1,120
S2024,Martha Hillard,5,53,46,104
S2025,Jesus Machida,16,61,68,145
S2026,June Dorman,98,41,9,148
S2027,Donna Gamba,51,79,59,189
S2028,Carolyn Allison,37,19,48,104
S2029,Michael Thompson,92,26,6,124
S2030,Valarie Gessford,96,14,24,134
S2031,Steve Brantley,9,23,56,88
S2032,Teresa Humphrey,63,84,94,241
S2033,Richard Thompson,87,62,11,160
S2034,Cassandra Bridgett,40,93,19,152
S2035,Jennie Latsha,52,29,15,96
S2036,Danielle Hanna,31,78,93,202
S2037,Austin Blazejewski,95,98,67,260
S2038,Glenn Brawley,96,74,87,257
S2039,Mary Neal,87,35,45,167
S2040,Jesse Kautz,88,13,71,172
S2041,Ramona Anderson,45,63,66,174
S2042,Carl Eversmeyer,70,94,81,245
S2043,Glenda Underwood,67,27,43,137
S2044,Belinda Teal,71,12,32,115
S2045,Eleanor Hedrick,31,81,42,154
S2046,Beverly Dillon,95,31,97,223
S2047,Donald Seeman,34,38,100,172
S2048,Josephine Giannetti,51,75,13,139
S2049,Daisy Golden,20,9,96,125
S2050,Jose Venson,82,55,26,163
S2051,Inez Nguyen,36,6,52,94
S2052,Miguel Todd,65,42,13,120
S2053,Xavier Nicholson,66,13,54,133
S2054,Kathleen Millsap,50,28,22,100
S2055,Curtis Talbert,41,10,77,128
S2056,Richard Bennett,22,44,90,156
S2057,Susie Fleming,83,89,90,262
S2058,Andres Boxx,59,18,11,88
S2059,Nicholas Ramos,39,25,84,148
S2060,Eva Johnson,38,92,78,208
S2061,Fred Debar,49,60,30,139
S2062,Jennifer Cokley,8,59,25,92
S2063,Adolph Grimes,88,40,17,145
S2064,Roxanne Newhall,12,53,25,90
S2065,Tracy Hicks,44,57,29,130
S2066,Donna Lynch,41,85,11,137
S2067,Steven Raneses,18,69,29,116
S2068,Donna Hoffman,21,53,57,131
S2069,Molly Montgomery,90,65,65,220
S2070,Kelly Cowan,30,46,99,175
S2071,Jerry Miller,60,23,90,173
S2072,Jeffrey Grayson,42,58,23,123
S2073,Maureen Mendez,89,3,71,163
S2074,William Lujan,18,81,10,109
S2075,Jenifer Patterson,65,94,98,257
S2076,Marie Henderson,70,1,51,122
S2077,Gwen Holloway,39,80,98,217
S2078,James Logan,66,59,58,183
S2079,John Dickens,60,18,10,88
S2080,Dwayne Schultz,10,93,15,118
S2081,Lucille Calhoun,97,62,50,209
S2082,Barry Stafford,81,57,62,200
S2083,Angelina Young,15,44,80,139
S2084,Regina Smith,47,45,22,114
S2085,Leslie Graham,21,43,40,104
S2086,Teresa Howland,58,74,97,229
S2087,Emma Peterson,73,23,83,179
S2088,Charles Farrar,71,38,46,155
S2089,Michael Healy,30,14,22,66
S2090,Josephine Whipple,26,10,97,133
S2091,Jeffery Pearl,77,30,6,113
S2092,Jerome Bright,30,57,55,142
S2093,Wanda Clune,34,100,58,192
S2094,Mary Pratt,33,76,80,189
S2095,Joann Cole,56,89,33,178
S2096,Jessie Alaimo,90,40,28,158
S2097,Michael Smith,84,67,95,246
S2098,Robert Armstrong,83,90,92,265
S2099,Sandra Simon,63,48,4,115
S2100,Dorthy White,26,42,52,120
S2101,William Lorentz,44,51,14,109
S2102,Lynda Easley,45,92,35,172
S2103,Roger Christopher,26,28,3,57
S2104,Megan Dickerson,23,33,55,111
S2105,Mary Bertrand,76,61,86,223
S2106,Geoffrey Smith,36,56,65,157
S2107,Ignacio Reed,62,77,28,167
S2108,Melvin Knupp,24,8,14,46
S2109,Colleen Sievers,89,31,43,163
S2110,Chantel Armstrong,45,31,8,84
S2111,Todd Shimmin,69,85,8,162
S2112,Terry Mahoney,50,62,85,197
S2113,Racquel Ring,33,83,78,194
S2114,Shannon Manning,31,39,11,81
S2115,Beverly Bishop,43,69,35,147
S2116,Katie Gibson,83,61,66,210
S2117,Andrea Bettendorf,97,72,13,182
S2118,Leroy Rand,14,45,27,86
S2119,Craig Webb,75,74,54,203
S2120,James Huckleberry,43,51,96,190
S2121,Amanda Mcmanus,90,59,27,176
S2122,Mary Gosman,5,54,85,144
S2123,Brian Dexter,58,3,89,150
S2124,Steven Tucker,32,65,48,145
S2125,Marilyn Fitz,48,21,3,72
S2126,Randell Harrington,55,6,47,108
S2127,Kathleen Edwards,46,35,69,150
S2128,Dolores Armstrong,81,2,67,150
S2129,Ramona Miranda,56,11,39,106
S2130,Sharon Ainsworth,20,84,20,124
S2131,Barbara Lavalle,73,83,56,212
S2132,Bobby Mckee,43,67,55,165
S2133,Aida Traylor,29,7,18,54
S2134,Deanna Chandler,28,53,54,135
S2135,Wilmer Mcneil,78,68,80,226
S2136,Raymond Lamm,42,31,60,133
S2137,George Upshaw,82,90,84,256
S2138,Michael Werra,25,28,80,133
S2139,Patricia Hyneman,41,80,97,218
S2140,Doris Husband,75,46,9,130
S2141,Roger Leatham,87,81,45,213
S2142,Naomi King,28,30,20,78
S2143,Janet Whitworth,86,27,14,127
S2144,Val Bradley,33,1,44,78
S2145,Eddie Flynn,97,42,53,192
S2146,Helen Short,78,59,79,216
S2147,Charles Fitzgerald,65,81,6,152
S2148,Jeffrey Paletta,53,73,89,215
S2149,Carrie Chandler,19,2,4,25
S2150,Floyd Torres,78,24,91,193
S2151,Vicki Bugarin,27,91,40,158
S2152,Mildred Walters,74,10,96,180
S2153,Patricia Kaiser,88,74,45,207
S2154,Anthony Richardson,73,69,67,209
S2155,Marshall Walker,78,69,2,149
S2156,Mike Brooks,11,86,2,99
S2157,Melissa Keys,62,48,7,117
S2158,Andrew English,91,35,25,151
S2159,Linda Kennedy,93,95,89,277
S2160,Bart Ortega,12,68,19,99
S2161,Michele Lopez,40,67,56,163
S2162,Robert Difranco,44,24,16,84
S2163,Karen Brown,63,44,70,177
S2164,Lori Quinones,59,12,78,149
S2165,Patricia Morgan,18,42,24,84
S2166,Bruce Brigham,77,91,99,267
S2167,Harold Brewster,78,2,27,107
S2168,Phillip Jackson,92,82,64,238
S2169,Rose Coffman,21,45,26,92
S2170,Mario Lee,99,60,46,205
S2171,Dean Makins,86,49,4,139
S2172,Lena Waldon,66,37,30,133
S2173,Sean Teems,75,91,9,175
S2174,Luther Osborne,7,63,68,138
S2175,Maria Funches,88,65,84,237
S2176,Frances Wade,95,9,4,108
S2177,Mary Tipton,66,45,99,210
S2178,Sheila Sandusky,1,2,61,64
S2179,Gary Goode,54,71,30,155
S2180,Franklin Enochs,6,94,35,135
S2181,Linnea Pope,20,52,21,93
S2182,Dorothy Bennett,17,46,89,152
S2183,Kathleen Garcia,51,32,38,121
S2184,Angelica Dillion,70,76,0,146
S2185,Elmer Stout,93,36,60,189
S2186,Mario Pierce,38,74,47,159
S2187,Robert Vasquez,47,8,30,85
S2188,Joyce Cruz,23,2,54,79
S2189,Larry Whitten,94,47,13,154
S2190,Gail Kehres,0,22,13,35
S2191,Walter Arellano,85,36,75,196
S2192,Carol Muller,68,19,50,137
S2193,Celia Herman,34,3,72,109
S2194,Nicole Cormier,96,33,94,223
S2195,Mary Defabio,99,33,2,134
S2196,Paul Perkins,23,25,19,67
S2197,Lynda Ward,74,76,95,245
S2198,Hubert Galloway,77,68,88,233
S2199,Barbara Sisco,62,31,73,166
S2200,Bobby Prichard,22,31,82,135
S2201,Priscilla Corbin,19,15,18,52
S2202,Jessie Heim,51,4,97,152
S2203,Margaret Quigg,16,88,57,161
S2204,Jeffrey Simons,60,85,23,168
S2205,Reginald Pride,11,4,75,90
S2206,Linda Nedley,80,20,85,185
S2207,Kimberly Byers,92,19,96,207
S2208,Paul Herman,79,86,49,214
S2209,Cynthia Dasilva,29,19,1,49
S2210,Matthew Palumbo,42,54,11,107
S2211,John Stclair,67,7,97,171
S2212,Lisa Wooley,81,97,0,178
S2213,Loretta Rodriguez,62,27,67,156
S2214,Gladys Dilworth,30,41,33,104
S2215,Harriet Reifsnyder,66,81,55,202
S2216,Michael Patton,30,61,8,99
S2217,Carolyn Montgomery,28,86,5,119
S2218,Wilbur Grobmyer,94,76,57,227
S2219,Kathleen Jones,54,45,34,133
S2220,Laverne Knickerbocker,37,48,89,174
S2221,Catherine Hefferon,40,5,50,95
S2222,Laura Moore,44,46,57,147
S2223,Nicole Cuellar,29,14,53,96
S2224,Nicole Lowman,71,16,40,127
S2225,Emily Weller,27,67,7,101
S2226,Carol Kovach,60,75,77,212
S2227,Mark Malone,22,5,19,46
S2228,Catherine Fisher,35,87,68,190
S2229,Georgia Tubbs,51,20,29,100
S2230,Rosetta Taylor,21,87,89,197
S2231,Jessica Ward,85,22,77,184
S2232,Gene Martin,43,43,43,129
S2233,Willie Kee,63,89,63,215
S2234,Mary Simmons,90,5,44,139
S2235,Richard Armstrong,21,100,86,207
S2236,Christoper Hines,28,74,42,144
S2237,Roberto Stauber,15,46,15,76
S2238,Matthew Tilley,29,59,22,110
S2239,Shane Hargrove,0,45,43,88
S2240,Angel Smith,85,86,10,181
S2241,Joseph Irby,44,2,85,131
S2242,Luis Fitzsimmons,38,79,17,134
S2243,Anthony Allen,2,77,15,94
S2244,Edgar Amador,41,42,76,159
S2245,Luis Lash,31,9,31,71
S2246,Bradley Saylor,39,31,74,144
S2247,Danny Castro,15,35,89,139
S2248,Gertrude Collins,73,80,38,191
S2249,Mark Toomey,18,100,17,135
S2250,Arturo King,48,39,77,164
S2251,Anthony Adu,54,77,22,153
S2252,Harry Jenkins,72,5,25,102
S2253,Nadine Huff,25,1,54,80
S2254,Douglas Parks,77,91,69,237
S2255,Colton Chavarria,1,23,2,26
S2256,Juanita Carey,67,80,35,182
S2257,Raymond Raphael,10,99,17,126
S2258,Gary Mcintosh,77,9,27,113
S2259,Sadie Richardson,51,11,50,112
S2260,Florence Clapp,52,37,58,147
S2261,Heidi Duckworth,57,92,50,199
S2262,Devin Mellow,15,99,60,174
S2263,Phyllis Angotti,87,36,73,196
S2264,Maria Rowan,81,45,74,200
S2265,Albert Brack,88,24,78,190
S2266,Patrick Hogue,20,65,57,142
S2267,Preston Parker,15,20,83,118
S2268,Bonnie Murphy,96,13,35,144
S2269,Richard Deleon,14,87,78,179
S2270,Andrew Beebe,73,2,55,130
S2271,Winona Benson,4,77,52,133
S2272,Melody Harley,57,17,80,154
S2273,Donald Knorr,52,0,88,140
S2274,Madeline Wojcik,51,81,95,227
S2275,Ruby Blank,89,33,32,154
S2276,Josefina Guyton,68,54,39,161
S2277,Betty Venecia,36,41,97,174
S2278,Henry Martin,36,32,10,78
S2279,King King,96,39,29,164
S2280,Kristi Briggs,59,21,69,149
S2281,Ronald Cochrane,54,27,17,98
S2282,Young Brehmer,20,25,62,107
S2283,Robert Adair,97,87,62,246
S2284,Elizabeth Hickey,51,11,64,126
S2285,Jani Daffin,43,24,15,82
S2286,Richard Vandercook,32,22,85,139
S2287,Christine Stein,5,15,7,27
S2288,Edgar Mingione,32,4,41,77
S2289,Eric Steuer,21,54,42,117
S2290,Logan Peavler,1,25,21,47
S2291,Gary Stevenson,30,8,25,63
S2292,Tony Thompson,36,14,86,136
S2293,Harry Warfield,99,90,17,206
S2294,Andy Orr,21,7,87,115
S2295,Jenny Bridges,27,40,53,120
S2296,Arlene Oliphant,92,17,22,131
S2297,Maria Marvin,91,90,32,213
S2298,Stephanie Payne,85,98,64,247
S2299,Beth Beck,49,93,37,179
S2300,Wanda Baker,3,7,14,24
S2301,Judy Davis,90,86,1,177
S2302,William Johnson,65,57,76,198
S2303,Norman Edelstein,74,19,30,123
S2304,Michael Powell,31,96,37,164
S2305,Rudy Lalk,20,32,40,92
S2306,Geraldine Myers,1,57,27,85
S2307,Maria Fitzgerald,40,10,88,138
S2308,Kevin Barnes,70,75,41,186
S2309,Cindy Case,50,32,12,94
S2310,Richard Flowers,88,96,37,221
S2311,Esther Morefield,24,53,31,108
S2312,Ernest Thompson,83,22,78,183
S2313,Richard Boling,98,88,47,233
S2314,Phillip Ridder,20,79,75,174
S2315,Tina Hersh,61,9,19,89
S2316,Mary Bellows,93,90,93,276
S2317,Mildred Mcknight,80,100,90,270
S2318,Daniel Sorbo,4,64,97,165
S2319,Trish Richardson,70,59,29,158
S2320,Damien Leavell,23,45,69,137
S2321,Jim Chappel,28,15,55,98
S2322,Joshua Gilbert,50,30,65,145
S2323,Guadalupe Lingbeek,71,12,4,87
S2324,Bryan Griffis,50,89,66,205
S2325,Louise Valot,41,50,91,182
S2326,Dorothy Krishun,61,39,88,188
S2327,Cecilia Rusten,83,55,57,195
S2328,Dorothy Flesher,4,4,87,95
S2329,Tony Brown,22,17,67,106
S2330,Sonja Jacobson,65,33,1,99
S2331,Jacqueline Grijalva,84,42,20,146
S2332,Doreen Basel,2,55,10,67
S2333,Jackie Blanchard,24,37,92,153
S2334,Richard Koop,93,49,67,209
S2335,Larry Foote,80,85,75,240
S2336,Ruben Whelan,25,76,65,166
S2337,Carl Martinez,93,5,26,124
S2338,Jessica Warren,8,30,16,54
S2339,Kristal Johnson,85,30,30,145
S2340,Angela Bell,32,27,16,75
S2341,Matt Gonzalez,23,77,93,193
S2342,Emily Giles,20,94,58,172
S2343,Tony Erickson,21,0,54,75
S2344,Deborah Roa,80,51,42,173
S2345,James Jenkins,65,11,98,174
S2346,Carrie Whitenton,91,51,51,193
S2347,Floyd Gurule,14,16,29,59
S2348,Steven Coleman,30,32,30,92
S2349,Amy Yung,42,59,77,178
S2350,Alice Tucker,76,100,4,180
S2351,Linda Taylor,78,91,48,217
S2352,Milton Wheeler,77,6,14,97
S2353,William Wozniak,60,54,85,199
S2354,Lois Brown,74,20,27,121
S2355,Jo Mischke,18,51,71,140
S2356,William Anderson,95,93,10,198
S2357,Rochelle Ivancic,62,96,93,251
S2358,Barbara Madho,57,49,96,202
S2359,Kevin Mellen,63,100,38,201
S2360,Walter Norman,17,59,54,130
S2361,Shannon Win,60,83,81,224
S2362,Janet Thomas,29,69,93,191
S2363,Sonny Farnsworth,19,56,100,175
S2364,Maud Honeycutt,93,53,43,189
S2365,Felicia Britt,56,28,44,128
S2366,Michael Deville,10,38,97,145
S2367,Henry Allen,5,17,11,33
S2368,Chris Owen,100,86,21,207
S2369,Sherly Leonard,12,81,99,192
S2370,Ronald Knight,63,21,77,161
S2371,Zachary Crawford,74,13,46,133
S2372,Winifred Thompson,20,64,18,102
S2373,Jason Miles,32,9,45,86
S2374,Merrill Gonzalez,72,36,26,134
S2375,Wai Harris,43,45,60,148
S2376,Marlene Robinson,92,8,92,192
S2377,Virginia Golden,10,30,86,126
S2378,Victoria Parker,21,25,76,122
S2379,Charles Evers,15,32,25,72
S2380,Shannon Morrow,32,74,52,158
S2381,Jessica Murray,78,16,50,144
S2382,Casey Houser,49,1,76,126
S2383,Coleman Sanders,73,33,98,204
S2384,James Smith,10,40,24,74
S2385,Shawn Coombs,21,39,86,146
S2386,Anthony Collins,83,67,6,156
S2387,Johnnie Casella,5,28,46,79
S2388,Melanie Balliew,100,5,75,180
S2389,Irving Gary,59,34,67,160
S2390,William Reed,78,20,34,132
S2391,Yolanda Mccan,24,70,55,149
S2392,Harold Thompson,91,55,44,190
S2393,Elaine Wright,82,32,23,137
S2394,Robert Quintana,78,12,58,148
S2395,Anna Pallan,8,39,63,110
S2396,Linda Williams,87,23,67,177
S2397,John Ahrenholtz,74,20,57,151
S2398,Kelley Barshaw,59,7,19,85
S2399,Roy Thuringer,62,24,70,156
S2400,Carl Louder,89,82,55,226
S2401,Kenneth Jackson,54,42,47,143
S2402,Anna Caffrey,53,29,25,107
S2403,Ronda Ruiz,33,11,91,135
S2404,Patricia Lang,82,73,44,199
S2405,Elfrieda Burnett,54,76,65,195
S2406,Joseph Marx,1,31,13,45
S2407,Jane Person,87,73,53,213
S2408,Jonathan Jones,66,41,42,149
S2409,Barbara Chesser,7,84,78,169
S2410,Gabriel Hodges,52,55,8,115
S2411,Rick Liu,98,30,4,132
S2412,Sabina Martin,50,16,98,164
S2413,Milton Juarez,62,50,43,155
S2414,Larry Hasenberg,36,90,53,179
S2415,Mary Chavez,11,46,74,131
S2416,Lloyd Royce,13,71,29,113
S2417,Marvin Lewis,91,18,7,116
S2418,John Perkins,0,46,34,80
S2419,William Skinner,39,8,34,81
S2420,Jeremy Cahill,5,59,0,64
S2421,Austin French,78,13,24,115
S2422,Carla Martin,16,24,17,57
S2423,William Bova,90,51,64,205
S2424,Kevin Morse,69,9,63,141
S2425,Robin Powell,8,11,25,44
S2426,Craig Robinson,50,85,41,176
S2427,Beulah Walker,35,38,87,160
S2428,Craig Burke,92,64,80,236
S2429,Robert Williams,59,60,77,196
S2430,Tammy Glover,7,40,90,137
S2431,Melissa Smith,58,4,10,72
S2432,Theo Sarnicola,39,67,5,111
S2433,Constance Harvey,76,34,79,189
S2434,Joel Dant,5,6,23,34
S2435,Alicia Goodman,17,58,35,110
S2436,Kim Barber,61,51,60,172
S2437,Leslie Konakowitz,72,72,92,236
S2438,Allen Burrell,10,70,10,90
S2439,Rosann Wood,80,84,44,208
S2440,Shirley Gooden,65,36,26,127
S2441,Gerald Elford,52,26,43,121
S2442,Joan Luther,19,74,45,138
S2443,William Kline,73,54,44,171
S2444,Thomas Dukes,54,72,55,181
S2445,Debra Sasser,14,66,88,168
S2446,Susan Thomason,89,89,34,212
S2447,Robin Ritchie,38,32,12,82
S2448,Stan Cabrera,66,89,64,219
S2449,Jason Kronenberg,100,68,80,248
S2450,Lester Lamb,16,17,63,96
S2451,Gloria Duncan,9,54,84,147
S2452,Mary Wilkerson,70,83,77,230
S2453,Hazel Truelove,24,5,80,109
S2454,James Strand,78,23,95,196
S2455,Russell Keithly,79,49,44,172
S2456,Charlene Ortiz,95,62,7,164
S2457,Jennifer Petrovic,18,1,98,117
S2458,Kimberly Thrasher,9,23,83,115
S2459,Rosemary Sosa,45,83,72,200
S2460,John Graham,40,15,24,79
S2461,Robert Tibbetts,99,52,98,249
S2462,Wanda Habbyshaw,56,30,40,126
S2463,Lee Anderson,55,74,46,175
S2464,Yolanda Connolly,75,74,75,224
S2465,Joyce Garcia,94,87,34,215
S2466,Dorothy Amann,81,29,32,142
S2467,Carol Jones,65,21,99,185
S2468,Randolph Creasey,80,96,44,220
S2469,Carrie Estrada,95,78,40,213
S2470,Jeanette Bell,55,57,72,184
S2471,Linda Gladwell,63,69,13,145
S2472,James Demarco,18,22,63,103
S2473,Danny Tatro,16,47,72,135
S2474,Frank Medina,15,14,55,84
S2475,Janie Allen,4,27,25,56
S2476,Jan Thompson,51,28,6,85
S2477,Richard Wilson,9,6,60,75
S2478,John West,14,42,85,141
S2479,Richard James,37,82,12,131
S2480,Donna Uhrig,18,53,62,133
S2481,Henry Black,46,55,68,169
S2482,Donald Maynard,100,61,12,173
S2483,Velma Osburn,63,78,82,223
S2484,Marco Zendejas,25,58,26,109
S2485,Tracy Robbins,64,50,59,173
S2486,Homer Gardner,73,64,38,175
S2487,Kelly Taylor,53,100,41,194
S2488,Audrey Hunking,98,72,74,244
S2489,Nathanial Putnam,18,33,25,76
S2490,Shelia Carson,6,3,85,94
S2491,Laura Jurczyk,39,3,29,71
S2492,Reginald Kelley,99,32,49,180
S2493,Angelica Bostick,10,29,36,75
S2494,Eleanor Porter,96,70,21,187
S2495,Lakeisha Goodman,15,43,67,125
S2496,Louis Abraham,82,19,25,126
S2497,Will Otero,9,49,38,96
S2498,Arthur Martin,22,91,88,201
S2499,Lauren Lepine,72,11,55,138
S2500,Dave Pierce,21,12,49,82
S2501,Roberto Smith,58,16,14,88
S2502,John Wegner,17,97,81,195
S2503,Gwendolyn Flom,77,65,17,159
S2504,Joshua Curcio,31,82,16,129
S2505,Elizabeth Marks,69,6,95,170
S2506,Andrew Messina,36,23,47,106
S2507,Howard Nies,14,60,68,142
S2508,Nancy Umana,84,58,48,190
S2509,Elmer Rios,93,29,52,174
S2510,John Morales,6,7,59,72
S2511,Jason Musetti,2,52,62,116
S2512,Darlene Kyle,78,50,58,186
S2513,Elmer Bunton,51,98,17,166
S2514,Thomas Breazeale,67,55,29,151
S2515,Cynthia Collette,31,79,100,210
S2516,Aimee Flanders,78,6,52,136
S2517,Kenneth Perry,24,60,46,130
S2518,Theresa Fultz,96,26,96,218
S2519,Deanna Banas,31,53,9,93
S2520,Donna Conrad,71,37,48,156
S2521,Patrick Mcginnis,21,10,32,63
S2522,Rosalie Bodkin,32,2,12,46
S2523,William Hernandez,51,87,11,149
S2524,Kimberly Wise,75,28,41,144
S2525,Wendi Mccormick,20,68,20,108
S2526,Herbert Baugh,25,5,89,119
S2527,Calvin Meister,19,91,90,200
S2528,Anthony Ballard,98,60,43,201
S2529,Rosalie Hahn,61,27,42,130
S2530,Faye Robinson,27,47,95,169
S2531,Shawn Bohne,38,15,50,103
S2532,Donald Nelson,19,82,97,198
S2533,Cecil Mccowan,61,61,13,135
S2534,John Manriquez,28,84,85,197
S2535,Danielle Nichols,23,87,91,201
S2536,Jerald Ramos,56,31,43,130
S2537,Curtis Tran,1,65,88,154
S2538,Stephen Chung,12,32,4,48
S2539,Janette Mitchell,70,44,13,127
S2540,Marie Balderas,59,75,90,224
S2541,Alexander Eubanks,80,5,73,158
S2542,Floyd Mccorkle,55,73,19,147
S2543,Anna Dickey,72,50,13,135
S2544,Debra Hull,87,17,76,180
S2545,Kenneth Reynolds,71,51,2,124
S2546,Ann Waters,56,47,7,110
S2547,Margaret Freeman,44,70,94,208
S2548,Birgit Lozier,14,55,20,89
S2549,Pearl Eubank,37,67,81,185
S2550,Kelly Lopez,22,38,38,98
S2551,Alexis Nugent,68,19,73,160
S2552,Jennifer Warren,10,99,14,123
S2553,Elizabeth Wood,60,52,89,201
S2554,Wilbur Tremblay,9,38,13,60
S2555,Stanley Cook,78,33,76,187
S2556,Megan Curtis,84,12,72,168
S2557,Jennifer Castillo,16,14,46,76
S2558,Kelly Allen,68,85,88,241
S2559,Abraham Vala,77,79,53,209
S2560,Karen Miller,39,65,52,156
S2561,Susan Ghent,40,72,87,199
S2562,Paula Taunton,2,95,42,139
S2563,Christopher Hannah,21,67,0,88
S2564,Lawrence Sequeira,45,93,48,186
S2565,Francis Quinn,50,40,63,153
S2566,Joseph Havercroft,50,60,3,113
S2567,Micheal Watkins,94,65,59,218
S2568,Oscar Jackson,29,78,61,168
S2569,Mary Sanchez,3,32,94,129
S2570,Harry Murray,61,93,93,247
S2571,Patsy Kelly,73,74,37,184
S2572,Ruth Chavez,24,69,87,180
S2573,David Pullen,31,86,48,165
S2574,Ronald Carrion,26,49,95,170
S2575,Michelle Read,62,5,64,131
S2576,Sheila Morrow,6,30,42,78
S2577,Carol Tiffin,84,2,56,142
S2578,Harvey Daniel,80,40,92,212
S2579,Tara Barnes,56,57,60,173
S2580,Danica Warren,26,5,82,113
S2581,Sheryl Pekarek,58,4,30,92
S2582,Timothy Marks,86,94,21,201
S2583,Melanie Buck,90,29,28,147
S2584,Suk Stanton,82,66,78,226
S2585,Arlene Hargrove,33,82,38,153
S2586,James Colarusso,92,34,6,132
S2587,Sharon Lindsay,46,84,6,136
S2588,Dennis Stoner,17,27,0,44
S2589,Timothy Walker,8,46,18,72
S2590,Victor Harris,33,14,55,102
S2591,Chad Mcmaster,65,94,83,242
S2592,James Gillard,51,55,74,180
S2593,Lizzie Greer,61,95,77,233
S2594,Suzanne Edwards,24,96,74,194
S2595,Terry Burns,34,71,69,174
S2596,Scott Allen,26,87,82,195
S2597,Thomas Marlow,6,70,64,140
S2598,Chad Parker,18,83,67,168
S2599,Carolyn Walker,29,34,5,68
S2600,Roger Solanki,91,24,34,149
S2601,Leonard Aiken,26,99,82,207
S2602,Virginia Herman,53,26,85,164
S2603,Charmaine Randolph,71,74,55,200
S2604,Albert Lance,19,16,84,119
S2605,Douglas Battle,29,68,93,190
S2606,Joseph Schwing,34,21,62,117
S2607,Michael Curry,10,5,1,16
S2608,Carole Young,25,77,74,176
S2609,Doris Hubbard,25,60,75,160
S2610,Charles Thomas,44,43,60,147
S2611,Margaret Stahlberg,3,80,61,144
S2612,Gregory Moore,73,51,57,181
S2613,Nancy Jones,36,49,45,130
S2614,Aaron Cann,61,68,43,172
S2615,Molly Meek,7,21,37,65
S2616,Sandy Holley,43,72,70,185
S2617,Jacqueline White,39,62,21,122
S2618,Ruth Brito,70,50,16,136
S2619,Kevin Crowson,26,19,94,139
S2620,Maurice Stein,86,27,43,156
S2621,Amy Bowen,32,25,14,71
S2622,David Martin,86,15,68,169
S2623,Mervin Grant,23,31,9,63
S2624,Robert Byrd,58,48,29,135
S2625,Joseph Brown,44,72,65,181
S2626,Daryl Wilson,66,52,75,193
S2627,Nancy Mcbride,88,46,94,228
S2628,Kimberly Christianson,39,40,72,151
S2629,George Rhen,15,13,12,40
S2630,William Kerber,90,32,56,178
S2631,Elsie Howard,47,73,77,197
S2632,Agnes Niece,39,89,0,128
S2633,Adelle Martin,95,48,6,149
S2634,Walter Howell,25,1,96,122
S2635,Angela Viola,37,54,71,162
S2636,Pamela Braxton,98,47,3,148
S2637,Iva Harp,53,28,34,115
S2638,Raymond Smith,37,9,92,138
S2639,Becky Portillo,98,46,64,208
S2640,Adrian Colby,24,20,39,83
S2641,Sheila Howard,66,18,35,119
S2642,Patsy Eller,98,68,40,206
S2643,William Colligan,41,88,91,220
S2644,Robert Herman,51,40,34,125
S2645,Javier Taylor,88,74,29,191
S2646,Jared Bremer,25,75,89,189
S2647,Vikki Walters,83,68,61,212
S2648,James Barbre,46,68,55,169
S2649,Yvette Mercado,61,91,56,208
S2650,James Burrowes,81,16,52,149
S2651,Andrew Medeiros,70,31,95,196
S2652,George Swafford,42,33,44,119
S2653,Oscar Brawer,62,32,79,173
S2654,Michael Vonbraunsberg,89,25,22,136
S2655,Steven Bernal,51,13,8,72
S2656,Ray Barrett,93,18,96,207
S2657,John Williams,67,0,22,89
S2658,Lisa Chambers,26,24,20,70
S2659,Andrew Amie,71,10,54,135
S2660,Bessie Feenstra,37,39,51,127
S2661,Victor Holland,49,42,47,138
S2662,Joseph Wright,0,80,31,111
S2663,Rebecca Comer,17,87,76,180
S2664,Odis Miller,69,90,53,212
S2665,Grace Wilson,70,22,23,115
S2666,Jason Kirwan,1,25,79,105
S2667,Deanna Spencer,48,12,28,88
S2668,Robert Barnes,1,60,32,93
S2669,Daphne Romeo,82,33,6,121
S2670,Jennie Hunsaker,75,34,10,119
S2671,Manuel Doody,16,11,86,113
S2672,Howard Nash,94,86,82,262
S2673,Jalisa Ramos,59,91,11,161
S2674,Kelly Lott,43,85,13,141
S2675,Marjorie Bourgeois,87,21,95,203
S2676,Celeste Hickox,96,36,51,183
S2677,Ann Bankston,45,1,92,138
S2678,Manuel Coughlin,30,62,82,174
S2679,Jerry Mathews,47,62,20,129
S2680,Marlene Starnes,89,84,57,230
S2681,Emily Barbetta,79,19,34,132
S2682,Marilyn Fitzpatrick,62,49,57,168
S2683,Therese Sargent,57,16,89,162
S2684,Rodrick Snyder,44,1,7,52
S2685,Jillian Brussel,95,49,17,161
S2686,Michael Petersen,65,8,81,154
S2687,Curtis Wilson,90,23,54,167
S2688,Michelle Myers,18,36,49,103
S2689,William Holsapple,73,79,31,183
S2690,Joseph Mccoy,17,73,60,150
S2691,Paul Brewer,28,21,48,97
S2692,Mandy Martines,1,15,21,37
S2693,Sheldon Redden,24,0,29,53
S2694,Traci Schmitz,36,29,75,140
S2695,Christopher Beasley,18,0,34,52
S2696,Carol Brown,5,64,46,115
S2697,Cedric Zimmerman,21,77,21,119
S2698,Todd Matesic,0,31,68,99
S2699,Paula Smith,76,39,60,175
S2700,Lance Romero,17,32,57,106
S2701,Patricia Maldonado,62,8,31,101
S2702,Dora Jones,88,35,73,196
S2703,Reynaldo Selby,33,9,16,58
S2704,Ronald Henning,79,7,70,156
S2705,Floyd Cohen,83,52,42,177
S2706,Minnie Ewing,58,49,60,167
S2707,Christine Huber,1,57,13,71
S2708,Rebecca Zeman,7,9,64,80
S2709,Roger Mackay,44,17,53,114
S2710,Brenda Norwood,16,3,45,64
S2711,Ashley Oyler,80,69,96,245
S2712,Catherine Myers,44,59,46,149
S2713,Geneva Cuffe,83,19,60,162
S2714,Pamela Farlow,68,32,74,174
S2715,Tony Belzer,62,7,79,148
S2716,Randy Hart,99,82,62,243
S2717,Beverly Obregon,68,50,54,172
S2718,Nicholas Brice,75,0,95,170
S2719,Bertha Grubb,45,81,90,216
S2720,Maude Gliem,81,100,90,271
S2721,William Weddle,96,80,7,183
S2722,Lenora Erikson,88,17,71,176
S2723,Shirley Hale,93,35,9,137
S2724,Jay Gillogly,95,10,98,203
S2725,Cynthia Dunlap,95,57,71,223
S2726,Latoria Linder,70,41,32,143
S2727,Agnes Owens,71,74,8,153
S2728,Julie Hudson,77,84,95,256
S2729,Mary Lykes,93,43,19,155
S2730,James Bruns,85,76,12,173
S2731,Audrey Bautista,34,11,19,64
S2732,Mary Mullens,23,56,89,168
S2733,Carrie Caponigro,12,87,81,180
S2734,Melinda Walker,97,90,4,191
S2735,Robert Leidall,65,24,15,104
S2736,Scott Mackie,75,79,15,169
S2737,Janet Crews,45,56,45,146
S2738,Alicia Compton,0,95,85,180
S2739,Trisha Marnell,84,92,53,229
S2740,Richard Turner,51,96,33,180
S2741,Floyd Rose,5,21,37,63
S2742,Tonya Palmer,29,81,43,153
S2743,Robert Runyon,24,97,11,132
S2744,Ashley Brooks,86,95,69,250
S2745,Bill Ashpole,21,2,69,92
S2746,Leigh Urrutia,41,36,45,122
S2747,Edna Mills,48,72,85,205
S2748,Chris Larkins,29,63,19,111
S2749,Brenda Grover,97,6,99,202
S2750,Mary Dorsey,96,32,53,181
S2751,Jennifer Marroguin,62,94,8,164
S2752,Rodney Florence,90,92,1,183
S2753,Frank Burton,7,51,79,137
S2754,Jerry Wolff,2,94,32,128
S2755,Eugene Belk,67,66,66,199
S2756,Paul Knight,32,42,73,147
S2757,Juan Adams,55,58,76,189
S2758,Stanley Walker,9,15,93,117
S2759,Katherine Martin,44,37,72,153
S2760,Chris Alexander,11,51,56,118
S2761,Carrie Lee,68,1,34,103
S2762,Carlos Lopez,58,52,80,190
S2763,Mary Leslie,7,81,4,92
S2764,Linda Beach,73,37,75,185
S2765,Irvin Miguel,25,13,91,129
S2766,Mary Glover,100,23,32,155
S2767,Jean Becker,80,27,47,154
S2768,Catherine Fulk,84,1,44,129
S2769,Patrica Davis,29,6,31,66
S2770,Lisa Medford,23,18,31,72
S2771,Josie Lacomb,94,24,59,177
S2772,Anne Moreno,41,60,100,201
S2773,Theodore Woodard,26,91,89,206
S2774,Joann Berman,89,7,100,196
S2775,Manuel Stubbs,55,79,73,207
S2776,Patricia Woolard,5,68,99,172
S2777,George Packer,88,82,73,243
S2778,Austin Hooks,17,18,4,39
S2779,Theresa Williamson,51,45,15,111
S2780,Michael Anderson,69,20,68,157
S2781,Karen Gegenheimer,95,83,1,179
S2782,Bette Pollock,44,30,32,106
S2783,Stephanie Perdue,99,41,72,212
S2784,Elizabeth Wilkinson,38,45,9,92
S2785,Frances Turman,53,85,1,139
S2786,Juanita Smith,4,49,6,59
S2787,Jenifer Burris,27,86,40,153
S2788,Norma Dennis,27,26,23,76
S2789,Ronald Mack,20,52,79,151
S2790,Paul Hazelwood,77,48,29,154
S2791,Loni Diaz,34,14,35,83
S2792,Elaine Bean,32,57,99,188
S2793,Raymond Butler,45,6,63,114
S2794,Damian Adam,81,65,4,150
S2795,Lael Hutsell,41,12,13,66
S2796,Frederic Lopes,23,91,95,209
S2797,Rosa Hudgens,55,7,25,87
S2798,Kyle Jines,68,18,75,161
S2799,William Robertshaw,8,93,60,161
S2800,Pamula Reed,40,7,76,123
S2801,Brian Paquet,94,53,99,246
S2802,Diane Wright,17,51,97,165
S2803,Ernest Reigstad,67,6,84,157
S2804,Marion Kavanagh,44,31,59,134
S2805,Janet Adams,45,62,79,186
S2806,Marcy Fogle,8,12,26,46
S2807,Florence Bailey,63,71,3,137
S2808,Michael Clark,32,26,93,151
S2809,Michael Thompson,7,85,65,157
S2810,Luis Dillard,6,87,24,117
S2811,Donald Moorhouse,70,51,13,134
S2812,Joseph Wyatt,16,76,1,93
S2813,Timothy Ballou,38,55,7,100
S2814,Rachel Gomez,6,31,6,43
S2815,Robert Nichols,16,52,63,131
S2816,Gary Schultz,45,15,10,70
S2817,Earl Legra,56,22,96,174
S2818,Johnnie Bechel,20,29,20,69
S2819,Kevin Regalado,76,33,74,183
S2820,Michael Swaine,46,23,22,91
S2821,Charles Olesen,99,8,96,203
S2822,Dustin Quigley,84,36,42,162
S2823,Emma Padilla,18,29,47,94
S2824,Linda Yazzie,45,100,72,217
S2825,Steve Campbell,20,16,32,68
S2826,Lisa Heaberlin,42,80,39,161
S2827,Larry Holmes,13,29,99,141
S2828,James Esmond,24,76,83,183
S2829,Blanche Henderson,61,97,8,166
S2830,Salvador Lehman,33,10,83,126
S2831,Austin Foster,26,44,76,146
S2832,Jason Sherwood,86,63,14,163
S2833,Andrew Crews,91,82,34,207
S2834,Stephanie Anthony,74,63,59,196
S2835,Robert Welch,88,61,25,174
S2836,Robert Leslie,6,51,9,66
S2837,Audrey Red,14,100,81,195
S2838,Seth Ryan,96,75,50,221
S2839,Darlene Guidotti,23,3,23,49
S2840,Jeremy Brennan,61,97,44,202
S2841,James Traylor,85,92,7,184
S2842,Diane Johnson,55,96,81,232
S2843,Jeremy Sutton,71,71,8,150
S2844,Kristina Loftis,43,95,86,224
S2845,David Letellier,29,58,91,178
S2846,April Smith,70,54,11,135
S2847,Brian Mcclure,15,39,79,133
S2848,Jennie Broadway,15,8,39,62
S2849,Patricia Hutchison,0,36,98,134
S2850,Christopher Crittenden,90,81,67,238
S2851,Leon Jones,49,18,92,159
S2852,Linda Lawson,100,29,54,183
S2853,William Leal,8,43,89,140
S2854,Issac Laughlin,8,38,74,120
S2855,Nancy Schuller,71,3,17,91
S2856,Nadine Wathen,4,59,53,116
S2857,Boyd Becker,10,35,3,48
S2858,April Barfield,17,63,34,114
S2859,James Severson,36,19,73,128
S2860,Benny Flesher,1,84,81,166
S2861,Barbar Thompson,77,22,73,172
S2862,Rosendo Porter,25,40,75,140
S2863,Leroy Arriaga,78,19,46,143
S2864,Micheal Morey,16,87,50,153
S2865,Jason Minter,43,84,19,146
S2866,Linda Sculley,15,27,18,60
S2867,Rochelle Rocha,89,94,52,235
S2868,Claudia Martinez,2,63,82,147
S2869,Angie Nolan,48,58,28,134
S2870,James Konakowitz,39,90,85,214
S2871,Lisa Rhudy,98,15,34,147
S2872,Robert Orosco,38,58,88,184
S2873,Esther Solis,11,54,15,80
S2874,David Seward,65,64,44,173
S2875,Karen Cearley,95,43,33,171
S2876,Mary Weber,47,91,44,182
S2877,Robert Pate,14,93,54,161
S2878,Jo Jacobson,60,76,19,155
S2879,Michael Steiger,39,16,72,127
S2880,Jimmy Baird,83,54,47,184
S2881,Melinda Herman,98,93,21,212
S2882,John Owen,15,17,27,59
S2883,William Holzman,25,63,71,159
S2884,Francis Mealer,43,71,9,123
S2885,Elbert Faust,6,61,26,93
S2886,Crystal Winkler,8,88,5,101
S2887,Jeffrey Pothoven,34,36,70,140
S2888,Wilfred Duffield,18,49,60,127
S2889,Dyan Caldwell,62,19,73,154
S2890,Wilford Watkins,63,61,28,152
S2891,Gabriel Kim,31,62,45,138
S2892,Shelton Ryan,20,41,58,119
S2893,Phillip Hess,43,97,75,215
S2894,Brian Thierry,36,82,26,144
S2895,Cynthia Allen,58,74,74,206
S2896,Walter Thomas,17,23,69,109
S2897,William Holloman,60,57,24,141
S2898,Brenda Trott,38,27,83,148
S2899,Sandra Depasquale,39,92,77,208
S2900,Mary Blumenfeld,18,37,69,124
S2901,John Cervantes,42,40,36,118
S2902,Earl Gray,29,100,48,177
S2903,Junior Smith,43,41,34,118
S2904,Mildred Kearney,41,2,84,127
S2905,Jessica Heron,66,64,71,201
S2906,Victoria Bakley,10,93,12,115
S2907,Christopher Walden,98,62,3,163
S2908,Susan Parks,96,39,95,230
S2909,Debra Sowell,18,51,17,86
S2910,Amy Merritt,47,75,52,174
S2911,Dorothy Ferrell,78,89,18,185
S2912,Judy Crumbley,88,54,67,209
S2913,Rafael Green,12,72,32,116
S2914,Dolores Nunnery,86,32,12,130
S2915,Celestine Bean,97,92,68,257
S2916,Theresa Dallaire,63,19,45,127
S2917,Jannie Miller,71,8,31,110
S2918,Sarah Rhodes,64,54,49,167
S2919,Larry Suggs,21,49,11,81
S2920,Sandra Preston,70,57,97,224
S2921,William Bayas,30,78,57,165
S2922,Mildred Theroux,62,78,9,149
S2923,James Fernandez,30,88,10,128
S2924,Margaret Wood,76,86,57,219
S2925,Leon Mcclure,35,33,71,139
S2926,Giuseppina Jules,65,13,97,175
S2927,Rodney Carpenter,20,89,3,112
S2928,Jose Moriarty,27,63,10,100
S2929,Terry Coats,78,44,39,161
S2930,Wade Kohnen,42,96,88,226
S2931,Paula Farrell,78,21,85,184
S2932,Eric Beck,36,52,98,186
S2933,Trisha Woolery,86,35,72,193
S2934,Donald Allbright,38,71,100,209
S2935,James Nevills,28,47,19,94
S2936,Katina Maldonado,38,47,10,95
S2937,Stephaine Mayer,30,13,39,82
S2938,Laura Reilly,15,63,66,144
S2939,Joan Mooney,85,53,26,164
S2940,Justin Dejackome,83,66,19,168
S2941,Joseph Cox,58,25,53,136
S2942,Alex Watson,73,97,55,225
S2943,James Johnson,74,76,99,249
S2944,Maria Hayes,46,63,18,127
S2945,Santos Elliott,81,33,14,128
S2946,Joseph Larsen,8,89,47,144
S2947,Edward Osborn,72,90,55,217
S2948,Jose Barrett,57,90,50,197
S2949,Martha Gardner,73,73,13,159
S2950,John Martinez,6,20,11,37
S2951,Luella Armstrong,9,16,76,101
S2952,Jamaal Dunkle,30,20,14,64
S2953,Donna Barretta,14,76,32,122
S2954,Barbara Mooney,83,69,75,227
S2955,Janet Shows,39,49,58,146
S2956,Lionel Carter,32,23,0,55
S2957,Manuel Huskey,52,100,38,190
S2958,Robert Albers,0,90,6,96
S2959,Daniel Roman,11,36,48,95
S2960,Timmy Leslie,50,65,40,155
S2961,John Mahoney,10,28,37,75
S2962,Lisa Marino,14,38,82,134
S2963,Cruz Daniels,72,12,80,164
S2964,Lisa Thomas,75,28,2,105
S2965,Wendy Halter,19,49,56,124
S2966,Johnny Collins,80,39,7,126
S2967,Su Redman,69,71,41,181
S2968,Robert Brown,55,91,1,147
S2969,Bettie Foreman,3,78,35,116
S2970,Megan Jordan,69,77,67,213
S2971,Yolanda Pappas,35,83,1,119
S2972,Jill Washington,54,98,0,152
S2973,Robert Harris,21,65,0,86
S2974,Herbert Gibbs,99,62,24,185
S2975,Alba Murray,7,39,27,73
S2976,John Beck,30,43,23,96
S2977,Kevin Schick,89,50,40,179
S2978,Sheri Counselman,24,1,65,90
S2979,Courtney Iribarren,84,21,80,185
S2980,Kurt Salvadore,57,48,29,134
S2981,Julia Hampton,99,91,75,265
S2982,Benjamin Obhof,29,9,13,51
S2983,Darrell Westbrook,35,36,52,123
S2984,Karen Patterson,100,4,31,135
S2985,William Duran,17,58,72,147
S2986,Miguel Larabee,63,42,84,189
S2987,Isaac Mcbride,2,90,28,120
S2988,Norman Dabney,58,32,13,103
S2989,Mary Manson,19,43,91,153
S2990,Hilda Rogers,67,1,23,91
S2991,David Smith,91,73,79,243
S2992,Virginia Dubois,56,89,10,155
S2993,Sean Tanner,83,8,3,94
S2994,Marie Mason,43,53,48,144
S2995,Kim Newberry,22,98,55,175
S2996,Leonard Carrithers,76,8,64,148
S2997,Michael Simmons,6,75,32,113
S2998,Rita Cobbs,14,3,98,115
S2999,Kristal Godfrey,84,99,58,241
S3000,Rubin Gabert,67,19,28,114
S3001,Lois Thompkins,16,90,29,135
S3002,Jason Sessions,14,41,19,74
S3003,Dennis Dunn,83,40,61,184
S3004,Charles Mitchell,91,89,90,270
S3005,Laura Pugh,5,11,71,87
S3006,Eddie Pena,59,49,90,198
S3007,Arthur Knight,45,50,6,101
S3008,Cynthia Greenler,56,59,4,119
S3009,Joshua Pickett,67,45,5,117
S3010,Kelley King,87,18,5,110
S3011,Sherrie Adams,35,97,3,135
S3012,Evelyn Digangi,32,95,31,158
S3013,Richard Henderson,59,14,48,121
S3014,William Grubbs,14,57,21,92
S3015,Steve Sanchez,46,10,9,65
S3016,Edith Carson,41,73,91,205
S3017,Paul Calloway,55,10,2,67
S3018,Luis Caballero,44,31,39,114
S3019,Jon Martin,70,52,57,179
S3020,Jenna Garcia,24,57,66,147
S3021,Jason Herring,63,98,87,248
S3022,Evelyn Small,43,100,39,182
S3023,John Howard,88,86,89,263
S3024,Harold Lynch,23,49,63,135
S3025,Charles Kasper,76,36,15,127
S3026,Bruce Penton,94,91,49,234
S3027,Scott Mathis,48,0,70,118
S3028,James Kriss,92,97,33,222
S3029,Ralph Casey,59,71,55,185
S3030,Stephen Innis,56,54,18,128
S3031,Wilfred Piatt,62,13,19,94
S3032,Jeff Mcvey,12,14,34,60
S3033,Heather Jasper,68,14,66,148
S3034,Crystal Jackson,10,48,58,116
S3035,Sandra Connor,56,55,15,126
S3036,Katherine Black,31,35,55,121
S3037,Paul Wilkerson,97,13,5,115
S3038,Marilyn Lewis,94,6,75,175
S3039,Frank Nichols,16,77,97,190
S3040,Frederick Carroll,94,3,47,144
S3041,James Wickham,99,44,84,227
S3042,Oscar Hunsberger,49,46,55,150
S3043,Doris Dolan,32,38,16,86
S3044,Earl Graber,27,17,86,130
S3045,Wanda Springfield,54,28,17,99
S3046,Jerry Laitila,88,21,88,197
S3047,Carter Masters,77,83,97,257
S3048,Diana Landor,73,9,53,135
S3049,Jean Floyd,19,92,15,126
S3050,Mary Schepens,13,54,98,165
S3051,Darlene Burris,74,30,13,117
S3052,Gwen Richmond,58,63,57,178
S3053,Jamie Smart,74,28,9,111
S3054,Alex Theriot,64,100,90,254
S3055,Crystal Richardson,99,36,58,193
S3056,Richard Bialaszewski,35,64,41,140
S3057,Toni Courtemanche,23,50,75,148
S3058,Jeremy Trotter,10,94,19,123
S3059,Teresa Picton,71,2,79,152
S3060,Edgar Zecca,47,15,20,82
S3061,Lillian Valenti,89,61,33,183
S3062,Tyler Bresnahan,54,40,46,140
S3063,Robin Stevens,49,77,95,221
S3064,Gerardo Garrett,22,36,18,76
S3065,Scott Martin,64,100,63,227
S3066,Virgil Wilson,8,77,82,167
S3067,Johanna Howell,78,27,96,201
S3068,Shirley Cox,14,74,13,101
S3069,Adam Chritton,42,66,53,161
S3070,Regina Wyatt,94,23,80,197
S3071,Chad Olson,26,86,73,185
S3072,James Whitley,94,63,91,248
S3073,Constance Haynes,54,30,71,155
S3074,Jose Keys,34,60,93,187
S3075,Robert Puleo,81,12,10,103
S3076,Dorothy Merrett,36,31,37,104
S3077,Lindsey Temple,95,94,100,289
S3078,Andrea Downing,85,23,96,204
S3079,Robin Mace,53,90,88,231
S3080,James Mascia,78,95,5,178
S3081,Minnie Reilly,78,83,24,185
S3082,John Smith,44,10,36,90
S3083,Phyllis Harris,88,40,65,193
S3084,Margery Dandurand,88,17,86,191
S3085,Audrey Levings,56,61,27,144
S3086,Brenda Haas,44,71,93,208
S3087,Eric Lim,0,38,19,57
S3088,Henry Murdoch,50,77,67,194
S3089,Brenda Blaylock,21,48,5,74
S3090,Jacob Gaston,29,93,47,169
S3091,Susanna Roney,9,10,54,73
S3092,Dorothy Williams,6,78,3,87
S3093,Wanda Pierce,31,9,81,121
S3094,Helen Gard,34,29,26,89
S3095,Victoria Beasley,56,52,30,138
S3096,Andy Wilhelm,10,80,31,121
S3097,Roosevelt Taylor,88,9,42,139
S3098,Edward Barden,3,22,66,91
S3099,Jonathon Mclaughlin,98,56,36,190
S3100,Danielle Fulcher,93,80,100,273
S3101,Stanley Roberts,42,1,81,124
S3102,Damian Reisman,24,13,30,67
S3103,Anthony Walker,11,99,32,142
S3104,Cedrick Rivera,87,81,4,172
S3105,Barbara Kelly,20,65,93,178
S3106,Mattie Rosenberg,24,89,18,131
S3107,Jonathan Dorsch,91,90,18,199
S3108,Laura Barrera,3,80,60,143
S3109,Ronald Peeden,74,64,11,149
S3110,Marvin Owens,79,11,58,148
S3111,Kyle Lukowski,32,73,19,124
S3112,Nathan Mazzariello,21,53,7,81
S3113,Doris Vellucci,98,19,60,177
S3114,Willie Wisse,25,50,20,95
S3115,Delilah Santos,77,33,4,114
S3116,Sandra Leblanc,45,38,4,87
S3117,Edward Nash,17,64,34,115
S3118,Steven Mullin,39,57,7,103
S3119,Joshua Schier,60,61,20,141
S3120,Stephen Horn,47,83,26,156
S3121,Kirk Rains,80,95,88,263
S3122,Amber Hill,33,14,7,54
S3123,Christie Heck,55,96,54,205
S3124,Eric Woods,10,39,11,60
S3125,Humberto Partridge,96,12,98,206
S3126,Lawrence Mcclure,70,80,4,154
S3127,Tamatha Glover,93,39,72,204
S3128,Harold Stevens,49,43,2,94
S3129,Steven Reeves,25,0,99,124
S3130,Wayne Deal,92,77,56,225
S3131,Art Ripper,47,52,30,129
S3132,John Dixon,51,16,13,80
S3133,Margaret Bondy,22,12,34,68
S3134,Suzanne Flowers,23,37,89,149
S3135,Bobbie Sims,57,25,24,106
S3136,Joyce Stacy,13,17,79,109
S3137,John Marinaccio,1,66,96,163
S3138,Terry Lee,11,30,6,47
S3139,Rosalie Mcmillan,44,2,34,80
S3140,Abe Fairbairn,33,98,27,158
S3141,Darlene Hearn,0,77,18,95
S3142,Mary Hawkins,54,40,45,139
S3143,Bobby Simpson,82,27,57,166
S3144,Lionel Snodgrass,58,24,69,151
S3145,Norman Richardson,55,4,87,146
S3146,Robert Gallagher,22,100,43,165
S3147,Bennie Brooker,47,52,41,140
S3148,Keith Matson,97,45,60,202
S3149,Ashley Moore,49,50,8,107
S3150,Ted Brown,55,37,69,161
S3151,Virginia Anderson,66,53,88,207
S3152,Gordon Andrews,49,66,44,159
S3153,Gloria Lowe,94,10,83,187
S3154,Lorraine Wallace,70,72,34,176
S3155,Zula Adams,20,44,85,149
S3156,Myrtle Llamas,13,7,79,99
S3157,Courtney Phillips,89,30,99,218
S3158,John Harding,56,31,0,87
S3159,William Herrera,46,42,58,146
S3160,Loretta Tyler,99,63,15,177
S3161,Edmund Kuehn,13,38,19,70
S3162,Daniel Shawver,73,32,80,185
S3163,Oscar Meyer,100,86,34,220
S3164,Daniel Escamilla,43,95,6,144
S3165,Jean Hines,11,37,49,97
S3166,Elizabeth Khan,22,78,13,113
S3167,Paul Sweeney,85,53,46,184
S3168,Barbara Marquez,93,51,90,234
S3169,Karen Narvaez,16,35,52,103
S3170,Robert Williams,21,71,36,128
S3171,Jorge Mitchell,42,85,22,149
S3172,Stephen Murphy,49,35,91,175
S3173,Charlena Trujillo,16,27,69,112
S3174,Tiffanie Harrison,50,20,90,160
S3175,Ann Ellis,82,62,79,223
S3176,Albert Cargile,8,33,100,141
S3177,Nicole Mullins,17,27,33,77
S3178,Michelle Mayoka,83,83,44,210
S3179,Lee Gambill,10,11,65,86
S3180,Bonnie Hopkins,37,59,49,145
S3181,Stephen Poulin,82,15,13,110
S3182,Robert Holland,89,90,72,251
S3183,John Austin,28,95,47,170
S3184,Delia Downer,6,21,0,27
S3185,Melanie Oneal,75,39,31,145
S3186,Catherine Werner,5,4,25,34
S3187,Eleanor Dameron,68,59,80,207
S3188,Gwendolyn Lilley,100,82,33,215
S3189,Noah Quincel,85,90,49,224
S3190,Alberto Grinder,81,73,9,163
S3191,Nancy Keith,72,80,98,250
S3192,Nancy Wal,26,17,44,87
S3193,Eric Connell,12,62,19,93
S3194,Vanessa Scaffidi,76,21,72,169
S3195,Daniel Parkerson,72,24,24,120
S3196,William Phillips,41,7,14,62
S3197,James Pipkin,92,70,85,247
S3198,Kelly Bradley,28,39,65,132
S3199,Heather Hooper,79,81,52,212
S3200,Gary Gonzales,16,29,16,61
S3201,Melanie Chester,66,59,17,142
S3202,Gerald Phillips,38,43,25,106
S3203,Staci Young,82,35,40,157
S3204,Mildred Henderson,5,28,49,82
S3205,Juan Towner,24,83,82,189
S3206,David Matty,11,58,77,146
S3207,Evon Harris,17,42,52,111
S3208,Matt Monahan,54,30,53,137
S3209,Donna Bowling,69,92,51,212
S3210,Nancy Hicks,12,57,97,166
S3211,Ralph Donovan,9,68,27,104
S3212,Gus Orman,62,78,59,199
S3213,Floyd Stiles,32,70,2,104
S3214,Andra Yeend,20,64,100,184
S3215,Pamela Santa,39,27,65,131
S3216,Walter Bloomquist,11,75,34,120
S3217,Willis Perkins,32,91,98,221
S3218,Teresa Sanderson,61,68,40,169
S3219,Josephine Ramos,74,52,61,187
S3220,Tina Kelly,1,95,79,175
S3221,Andrew Norman,86,13,88,187
S3222,Preston Fisher,62,61,31,154
S3223,Lisa Thomas,60,89,56,205
S3224,Jose Arnold,45,47,98,190
S3225,Vera Ritchie,96,27,5,128
S3226,Vicki Thomas,39,26,40,105
S3227,Shirly Love,19,77,26,122
S3228,Kenneth Robinson,5,39,15,59
S3229,Lisa Mory,20,69,82,171
S3230,David Vicini,60,80,97,237
S3231,Margaret Jones,87,93,26,206
S3232,Kelli Edwards,11,61,24,96
S3233,Kenneth Powell,71,12,80,163
S3234,Thomas Sughrue,67,85,71,223
S3235,John Jodha,98,90,12,200
S3236,John Jablonski,49,24,93,166
S3237,Dianna Davis,85,24,48,157
S3238,Jayme Chan,100,48,71,219
S3239,Eva Hall,22,40,86,148
S3240,Michael Hoffpauir,35,64,99,198
S3241,Irene Burgess,28,37,33,98
S3242,Jan Lee,28,44,42,114
S3243,Trevor Ehmann,60,26,12,98
S3244,Jason Canter,39,49,3,91
S3245,Kimberly Ward,61,9,19,89
S3246,Thomas Iman,65,94,62,221
S3247,Edward Wade,30,38,13,81
S3248,Billy Marshall,19,93,91,203
S3249,Catherine Hernandez,92,73,59,224
S3250,Howard Beard,50,45,64,159
S3251,Kristy Skowron,27,95,33,155
S3252,Idell Speck,91,48,96,235
S3253,Kevin Turnipseed,40,67,39,146
S3254,Ruth Mccann,5,0,53,58
S3255,Carrie Wright,38,74,57,169
S3256,Elias Wright,86,57,1,144
S3257,Gary Dinatale,27,58,23,108
S3258,Gary Osborne,90,54,84,228
S3259,Melanie Shaffer,28,92,59,179
S3260,Shawn Ramos,25,6,33,64
S3261,Charlie Sullivan,26,61,15,102
S3262,Lisa Sutton,85,56,37,178
S3263,Joseph Baird,6,74,13,93
S3264,Kari Owens,42,4,36,82
S3265,Lorenzo Rice,85,13,48,146
S3266,Stasia Frye,15,24,25,64
S3267,Michael Dill,96,15,14,125
S3268,Eleanor Mcwilliams,12,90,18,120
S3269,Richard Greenberg,89,93,67,249
S3270,Mike Eckhardt,2,23,80,105
S3271,Helen Daly,25,89,59,173
S3272,Edmond Andrus,86,11,51,148
S3273,Thomas Colon,18,4,43,65
S3274,Ione Fontenette,95,0,40,135
S3275,Tim Phillips,12,23,77,112
S3276,Carolyn Fowler,54,23,62,139
S3277,Miriam Zamora,57,97,79,233
S3278,Brenda Jaramillo,65,14,53,132
S3279,Harry Wilson,90,36,100,226
S3280,Kim Verhoeven,79,71,28,178
S3281,Steven Thorn,11,38,8,57
S3282,Calvin Sepulveda,77,56,52,185
S3283,Margaret Riebau,8,26,81,115
S3284,Tristan Wray,22,64,81,167
S3285,Elvira Horner,86,88,13,187
S3286,Timothy Sanchez,37,40,95,172
S3287,Roberta Smith,20,36,8,64
S3288,May Hartt,8,18,58,84
S3289,William Leingang,91,15,20,126
S3290,Muriel Dennison,44,58,88,190
S3291,Hazel Maney,25,72,43,140
S3292,Katie Montalvo,76,24,23,123
S3293,Joy Cass,98,31,1,130
S3294,Douglas Price,33,72,10,115
S3295,Marion Field,60,53,40,153
S3296,Gene Blethen,49,28,71,148
S3297,Katherine Owens,62,22,93,177
S3298,Laura Thorpe,74,43,77,194
S3299,Charmaine Simpon,54,28,58,140
S3300,Pamela Mitchell,15,22,39,76
S3301,Yolanda Vogel,73,80,14,167
S3302,Robert Moskovitz,3,11,54,68
S3303,Lorraine Davenport,90,9,94,193
S3304,Anthony Edwards,86,92,73,251
S3305,Peter Potter,68,13,24,105
S3306,Greg Duncan,80,76,60,216
S3307,Marcella Thammavongsa,47,93,40,180
S3308,Frances Carr,65,63,95,223
S3309,David Horr,92,28,55,175
S3310,Martha Myrick,23,58,77,158
S3311,Joshua Moore,38,75,29,142
S3312,Clifford Burgess,59,26,96,181
S3313,Norma Rowe,27,21,6,54
S3314,Martin Cross,36,79,40,155
S3315,Jack Watson,81,61,12,154
S3316,William Hancock,18,87,91,196
S3317,John Joachim,40,32,91,163
S3318,Claudia Brehm,74,96,61,231
S3319,Justin Kline,71,47,76,194
S3320,Lura Fruge,25,66,26,117
S3321,Roger Miller,27,21,40,88
S3322,Wilma Bowman,55,43,89,187
S3323,Michael Mcgowin,64,35,35,134
S3324,Tiffany Small,85,80,16,181
S3325,Joseph Jones,21,80,33,134
S3326,Jamie Sisk,20,25,55,100
S3327,Chu Morgan,4,84,54,142
S3328,Carole Turner,37,25,17,79
S3329,Karen Steffensmeier,76,89,79,244
S3330,Jamie Arnett,27,68,57,152
S3331,Emma Gerber,48,12,30,90
S3332,Cameron Clore,37,22,76,135
S3333,Beth Kinlaw,75,79,82,236
S3334,Andrew Josefy,100,47,54,201
S3335,Joanne Murch,46,96,6,148
S3336,Stephanie Knowles,59,14,52,125
S3337,Travis Laso,20,3,49,72
S3338,Patrick Sonoda,14,45,10,69
S3339,Mark Arnold,75,91,60,226
S3340,Marco Trimarchi,87,80,16,183
S3341,Fred Lopez,54,37,87,178
S3342,Emily Fiecke,94,41,58,193
S3343,Cecil Parkinson,68,86,25,179
S3344,Frank Miller,93,68,67,228
S3345,Sharon Lizotte,1,94,48,143
S3346,Mary Ozga,44,30,1,75
S3347,Karen Tobin,45,7,81,133
S3348,Coleen Sheppard,88,30,44,162
S3349,Lisa Struck,47,19,15,81
S3350,Michael Reilly,37,78,84,199
S3351,Ella Kiffer,45,16,23,84
S3352,Frederick Eshom,48,54,76,178
S3353,Eleanor Johnson,93,64,80,237
S3354,Cecil Lovelace,24,21,64,109
S3355,Chanell Orman,85,20,68,173
S3356,Kelly Mccall,48,79,59,186
S3357,Elizabeth Nix,24,40,32,96
S3358,Gail Goris,77,28,15,120
S3359,John Murray,93,82,86,261
S3360,Hettie Meredith,38,41,40,119
S3361,Willie Smith,70,56,70,196
S3362,Susie Rothschild,21,58,50,129
S3363,George Morales,8,6,100,114
S3364,Barbara Brown,85,68,60,213
S3365,Karen Hannah,34,36,68,138
S3366,Timothy Walker,78,96,73,247
S3367,Keri Ward,3,75,35,113
S3368,Edna Basque,5,22,31,58
S3369,Jennifer Colston,12,15,84,111
S3370,Lynne Parker,82,97,66,245
S3371,Claire Dykes,47,20,58,125
S3372,Benjamin Patrick,30,9,91,130
S3373,Michael Alexander,91,77,17,185
S3374,Joyce Ross,30,15,35,80
S3375,Marilyn Powers,39,69,96,204
S3376,Lolita Hardy,58,62,37,157
S3377,Johnnie Hartl,28,71,45,144
S3378,Stephen Gillespie,25,2,38,65
S3379,Michael Mann,99,15,70,184
S3380,Daniel Peterson,73,11,72,156
S3381,Gregory Hagadone,92,65,38,195
S3382,Sherie Mitchell,16,65,33,114
S3383,Sue Shibley,14,89,97,200
S3384,Robert Lloyd,92,33,36,161
S3385,Frederick Anderson,47,95,0,142
S3386,Sandra Alteri,93,17,82,192
S3387,Alicia Baldwin,21,2,98,121
S3388,Bob Burris,96,70,65,231
S3389,Helen Meissner,48,9,25,82
S3390,Patti Byers,66,68,26,160
S3391,Beatrice Brent,76,75,2,153
S3392,Charles Freeman,38,82,10,130
S3393,Wayne Bender,4,74,74,152
S3394,Debbie Wrubel,10,35,19,64
S3395,Russell Weldon,11,32,33,76
S3396,Shirley Alcott,15,72,79,166
S3397,Bessie Williams,84,11,24,119
S3398,David Grant,62,21,67,150
S3399,Patrick Flowers,62,36,1,99
S3400,Elizabeth Martin,59,54,63,176
S3401,Michael Lewallen,25,92,72,189
S3402,Lee Germain,10,21,75,106
S3403,Fannie Cambre,53,70,46,169
S3404,Nell Hinojosa,70,64,26,160
S3405,Lori Holmes,30,35,77,142
S3406,Daniel Hendricks,63,40,88,191
S3407,Thurman Wilson,48,53,56,157
S3408,Alison Hutchinson,33,90,12,135
S3409,Phil Ward,36,29,68,133
S3410,Floyd Bustos,79,65,1,145
S3411,William Thompson,25,7,99,131
S3412,Laura Lanham,99,44,100,243
S3413,Cindy Salis,54,71,47,172
S3414,Mary Dejardin,46,43,37,126
S3415,Katherine Burke,55,14,3,72
S3416,Rosalind Rester,29,20,53,102
S3417,Barbara Campoy,70,19,25,114
S3418,Jennifer Smalls,41,34,46,121
S3419,Sheila Degraffenreid,2,71,81,154
S3420,Curt Mcbee,82,56,49,187
S3421,Renee Reeb,100,91,42,233
S3422,Tasha Peevey,49,15,14,78
S3423,Teresa Kuziel,36,83,74,193
S3424,Laura Mathis,19,53,26,98
S3425,Pauline Andress,64,79,64,207
S3426,Melody Cox,83,42,76,201
S3427,Troy Lopinto,100,65,3,168
S3428,Sheila Neider,93,90,9,192
S3429,Timothy Gribbin,12,54,72,138
S3430,Patricia Bullock,54,53,49,156
S3431,Candy Mclean,65,7,58,130
S3432,William Lee,57,91,7,155
S3433,Michael Perez,48,16,92,156
S3434,Roy Hunt,7,17,76,100
S3435,Juan Mckinney,15,76,90,181
S3436,Patricia Mauldin,0,28,65,93
S3437,John Rutledge,88,79,16,183
S3438,Patricia Mckay,36,25,84,145
S3439,Andres Gilliland,60,44,72,176
S3440,Bobby Brown,93,99,59,251
S3441,Michael Andino,66,23,100,189
S3442,Dean Bradford,82,84,49,215
S3443,Scotty Brown,46,73,12,131
S3444,Johnnie Thomas,100,11,82,193
S3445,Keith Mcneal,0,99,21,120
S3446,Sue Negron,1,8,20,29
S3447,Frances Kohler,38,52,58,148
S3448,Ruby Ernst,74,78,41,193
S3449,Kenneth Doland,46,88,7,141
S3450,Kim Crilly,63,20,34,117
S3451,John Wilson,53,12,41,106
S3452,Sonia White,40,79,66,185
S3453,Shelly Rall,4,93,31,128
S3454,Kelly Nelson,93,25,33,151
S3455,Robert Pederson,25,11,60,96
S3456,Travis Tomopoulos,10,58,93,161
S3457,Lillian Frison,3,96,1,100
S3458,Gina Shafer,73,5,73,151
S3459,Chelsea Smith,96,46,5,147
S3460,Russell Allison,2,58,39,99
S3461,Pedro Mercer,61,78,90,229
S3462,Antonio Petty,99,43,44,186
S3463,Jillian Leone,6,6,81,93
S3464,Ellen Sampsell,29,45,43,117
S3465,John Sperling,52,58,10,120
S3466,Donna Adams,8,67,13,88
S3467,Ernest Downs,93,83,49,225
S3468,Cynthia Sanders,48,84,75,207
S3469,Lawrence Hall,88,18,37,143
S3470,Angel Hinson,9,30,51,90
S3471,Doris Briant,89,4,77,170
S3472,Teresa Montes,82,64,0,146
S3473,Terry Carualho,28,88,90,206
S3474,Joyce Ung,21,92,80,193
S3475,Lorie Garcia,81,60,4,145
S3476,Charles Cole,49,90,39,178
S3477,Ann Perez,48,92,14,154
S3478,Emily Wellman,26,51,75,152
S3479,Jeanette Montoya,22,37,66,125
S3480,Terry Lowers,52,61,51,164
S3481,Dorothy Hurt,58,65,66,189
S3482,Clair Leon,46,24,34,104
S3483,Marvin Hewitt,38,10,39,87
S3484,Bridgette Mclean,26,49,37,112
S3485,Tamika Crawley,74,72,87,233
S3486,Margaret Glass,15,31,46,92
S3487,Sylvia Hogan,4,9,36,49
S3488,John Mason,99,31,38,168
S3489,Jim Silveira,90,37,80,207
S3490,Bernice Goud,56,22,42,120
S3491,Kevin Campbell,58,60,20,138
S3492,Cierra Castro,90,85,16,191
S3493,Andrew Thomas,82,37,46,165
S3494,James Fletcher,97,28,86,211
S3495,Martha Robinson,17,9,87,113
S3496,James Jackson,76,93,35,204
S3497,Douglas Broadnax,46,11,77,134
S3498,Luis Faiella,36,6,62,104
S3499,Angela Medina,29,56,65,150
S3500,Anthony Skinner,69,74,77,220
S3501,Cynthia Escamilla,45,53,63,161
S3502,Don Conner,68,37,51,156
S3503,Latosha Riffe,44,27,85,156
S3504,Edward Watson,42,25,60,127
S3505,Joseph Stewart,45,97,4,146
S3506,Eva Bentley,100,89,53,242
S3507,Sylvia Craft,30,78,17,125
S3508,Don Judge,60,56,19,135
S3509,Michael Boykin,18,78,97,193
S3510,Brian Burton,58,25,17,100
S3511,Abraham Mckay,48,4,52,104
S3512,Edward Moore,37,92,22,151
S3513,Migdalia Lodge,12,96,1,109
S3514,Katherine Fuller,59,71,13,143
S3515,Kristopher Miller,36,41,51,128
S3516,Jeremy Hinkle,6,32,70,108
S3517,Henry Marroquin,16,20,67,103
S3518,Margaret Wyatt,86,49,21,156
S3519,Donn Mclaughlin,74,5,77,156
S3520,Zane Mahon,96,89,17,202
S3521,Corina Delligatti,5,15,62,82
S3522,Darlene Powell,10,33,86,129
S3523,Paul Johnson,43,63,92,198
S3524,Larry Reeser,52,90,87,229
S3525,Walter Greeson,9,73,100,182
S3526,Jeremy Bustad,40,34,41,115
S3527,Jeanette Haney,35,57,92,184
S3528,Rodney Wolfe,0,2,83,85
S3529,Sondra Uerkwitz,78,76,85,239
S3530,Reynaldo Rounds,10,71,79,160
S3531,Kristin Gardiner,23,13,32,68
S3532,Eva Griffith,64,46,97,207
S3533,Sallie Williams,59,23,0,82
S3534,Ethel Mcdonald,24,73,53,150
S3535,Bert Devoe,28,52,27,107
S3536,Joey Mesa,80,38,28,146
S3537,Robert Mayfield,82,35,54,171
S3538,Edward Rife,54,48,88,190
S3539,Jerry Wallace,54,3,15,72
S3540,Karen Hahn,91,26,13,130
S3541,Kenneth Parkinson,22,77,94,193
S3542,Van Baron,11,99,89,199
S3543,Louis Martin,79,40,92,211
S3544,Stephen Luna,22,22,44,88
S3545,Carol Phillips,83,78,96,257
S3546,David Dailey,90,67,36,193
S3547,Willie Johnson,93,36,74,203
S3548,Rebecca Lynn,55,84,11,150
S3549,Ronald Jiles,97,30,88,215
S3550,Renee Ferraro,10,63,59,132
S3551,Robert Schiano,82,49,77,208
S3552,Robert Pectol,25,31,1,57
S3553,Donovan Cortez,58,66,47,171
S3554,Derek Chism,18,69,61,148
S3555,Hanna Murley,43,52,90,185
S3556,Morgan Sheekey,30,1,66,97
S3557,Kelly Rasberry,100,84,49,233
S3558,Marta Singleton,87,24,67,178
S3559,Thomas Ogle,19,53,9,81
S3560,Alfred Jones,25,21,50,96
S3561,Brian Brunelle,63,35,20,118
S3562,Donald Jefferson,64,95,83,242
S3563,Gene Taylor,41,83,96,220
S3564,Leona Fricks,32,46,89,167
S3565,Walter Ray,51,1,7,59
S3566,Christine Rosenberg,47,74,22,143
S3567,Alfonso Helms,82,9,55,146
S3568,Erica Gleason,55,25,67,147
S3569,Pat Gill,23,17,95,135
S3570,Monique Favela,79,98,32,209
S3571,Patricia Prater,28,43,99,170
S3572,Jo Sherrill,95,64,5,164
S3573,Josephine Folsom,41,21,26,88
S3574,Eddie Barnes,69,89,34,192
S3575,Richard Kilker,73,16,61,150
S3576,Warren Good,30,35,8,73
S3577,Alycia Wilson,8,17,30,55
S3578,Jeanette Bickel,53,91,61,205
S3579,Barbara Roberts,10,36,23,69
S3580,Alissa Johnson,31,56,66,153
S3581,Jessica Bryant,85,26,98,209
S3582,Jacob James,39,34,33,106
S3583,Lillie Ogden,91,100,65,256
S3584,Tommy Young,30,4,57,91
S3585,Laurie Hoover,52,66,23,141
S3586,Claudia Kramer,29,19,91,139
S3587,Linda Gabrielsen,52,93,27,172
S3588,Mae Andrews,61,77,58,196
S3589,Jeffry Reed,93,70,67,230
S3590,John Worthy,89,68,65,222
S3591,Annette Armbruster,90,5,46,141
S3592,Mercedes Pesce,88,97,26,211
S3593,Erma Rogers,93,2,30,125
S3594,Otto Wade,13,26,73,112
S3595,Robin Smith,34,78,39,151
S3596,Olivia Ocegueda,99,6,17,122
S3597,Gary Selfridge,81,93,75,249
S3598,Eric Jones,70,91,25,186
S3599,Danny Chronister,95,59,90,244
S3600,Terence Heath,38,15,88,141
S3601,Patrick Pederson,8,26,56,90
S3602,Margaret Aubin,12,52,26,90
S3603,Mary Walker,35,1,23,59
S3604,Raymond Alexander,53,40,9,102
S3605,Jodi Croft,78,97,59,234
S3606,Lonnie Johnston,58,28,99,185
S3607,Carmen Smith,45,62,52,159
S3608,Helen Hilderbrandt,69,1,32,102
S3609,David Maris,3,63,82,148
S3610,Jimmy Hinkle,80,43,5,128
S3611,Paul Wilmore,53,84,13,150
S3612,Hung Lawyer,28,5,75,108
S3613,Cathryn Young,86,72,80,238
S3614,Jackie Mcinnis,20,62,5,87
S3615,Ila Jennings,18,81,59,158
S3616,Cynthia Jones,61,57,92,210
S3617,Jay Ramos,26,11,82,119
S3618,Pamelia Oleary,77,89,96,262
S3619,Rachel Lee,27,83,34,144
S3620,Lacey Donati,44,89,24,157
S3621,Amanda Bryant,86,80,70,236
S3622,Denise Wheeler,32,43,44,119
S3623,Marshall Devoy,7,57,32,96
S3624,Jennifer Hodgkins,1,78,95,174
S3625,Jerry Kwak,41,10,27,78
S3626,Jennette Mccollough,69,77,26,172
S3627,Justin Vance,49,17,81,147
S3628,Nicole Hurd,65,13,61,139
S3629,John Myers,99,79,12,190
S3630,Grant Dauenhauer,28,49,56,133
S3631,William Jackson,40,6,5,51
S3632,Edwin Padilla,99,50,8,157
S3633,Myra Burns,48,0,17,65
S3634,Nereida Mason,78,66,15,159
S3635,Wayne Lacoste,67,53,61,181
S3636,Peggy Ponder,73,16,91,180
S3637,Brenda Morales,52,56,25,133
S3638,Kent Rutledge,42,39,3,84
S3639,Audrey Tokarski,13,51,7,71
S3640,Joanna Robbins,62,26,67,155
S3641,Damian Fowler,23,81,100,204
S3642,Sheryl Mccall,75,63,99,237
S3643,Charles Bullman,21,61,12,94
S3644,Douglas Clark,83,88,77,248
S3645,David Corona,66,82,69,217
S3646,Leatrice Ford,97,84,86,267
S3647,John Leadbetter,76,74,3,153
S3648,Charles Doughtie,29,14,48,91
S3649,Mayme Dow,72,59,76,207
S3650,Theresa Hammonds,12,27,22,61
S3651,Diane James,83,38,7,128
S3652,Jesse Egan,78,86,74,238
S3653,Louise Williams,7,83,23,113
S3654,Jesus Roman,51,88,31,170
S3655,Norma Gaskin,22,55,90,167
S3656,Julius Holmes,21,93,76,190
S3657,Heather Medina,73,72,88,233
S3658,Edward Jeffries,13,82,52,147
S3659,Thomas Huard,92,44,47,183
S3660,Lucinda Robel,16,95,69,180
S3661,Richard Watson,90,49,25,164
S3662,Vanessa Rodriguez,29,47,37,113
S3663,Carlos Williams,39,18,84,141
S3664,Arron Wideman,95,56,71,222
S3665,George West,35,69,70,174
S3666,Beverly Dibbles,85,0,43,128
S3667,David Tedrick,0,83,12,95
S3668,Helene Stough,77,55,39,171
S3669,Evelyn Holman,47,30,13,90
S3670,Teodoro Larson,55,100,1,156
S3671,Rosalie Canada,87,90,28,205
S3672,Michael Graciano,88,86,39,213
S3673,Rosalind Castillo,25,42,54,121
S3674,Virginia Johnson,13,6,77,96
S3675,Benjamin Oneal,14,49,44,107
S3676,Mary Cortez,92,8,98,198
S3677,Tera Rivera,57,23,75,155
S3678,Mary Jones,39,25,52,116
S3679,Christine Stephens,84,94,62,240
S3680,Tom Garcia,51,49,94,194
S3681,Kelly Akers,70,48,58,176
S3682,Leonarda Coleman,27,97,84,208
S3683,Alma Kath,81,52,98,231
S3684,Adam Price,74,88,76,238
S3685,Rosa Herrington,78,33,88,199
S3686,Donna White,59,70,69,198
S3687,Johnnie Hill,56,53,16,125
S3688,Humberto Christopher,88,83,91,262
S3689,Lucille Reece,78,41,58,177
S3690,Christopher Fink,67,55,9,131
S3691,Ada Brigman,95,23,87,205
S3692,Joy Erickson,1,1,74,76
S3693,Steven Fountain,40,63,67,170
S3694,Patrick Chavez,60,4,40,104
S3695,Dorothy Applewhite,61,5,94,160
S3696,Penny Aldrich,76,5,92,173
S3697,Anne Klingensmith,42,7,91,140
S3698,Ricky Baldridge,87,15,38,140
S3699,Jeannette Taylor,38,62,67,167
S3700,Sylvia Price,8,97,39,144
S3701,Robert Sanders,88,83,36,207
S3702,Gayle Crout,33,24,12,69
S3703,Paul Jedele,21,37,0,58
S3704,Devon Hinz,73,23,22,118
S3705,Andrew Welch,96,97,15,208
S3706,Eva Mullins,13,87,20,120
S3707,Richard Head,79,67,70,216
S3708,Synthia Graham,81,88,54,223
S3709,Virginia Johnson,7,30,42,79
S3710,Jason Thigpen,17,76,33,126
S3711,Norbert Green,7,27,11,45
S3712,Barbara Knudsen,80,87,71,238
S3713,Laverne Bowers,5,81,93,179
S3714,Agnes Bonner,13,45,95,153
S3715,Dustin Tuller,12,98,35,145
S3716,Marietta Lebeau,54,93,24,171
S3717,Benjamin Nugent,98,13,0,111
S3718,Thurman White,26,58,98,182
S3719,Phyllis Conn,70,96,81,247
S3720,Ida Jenkins,29,65,25,119
S3721,Charlotte Strauser,75,75,86,236
S3722,Jackqueline Ruhl,27,90,1,118
S3723,Timothy Rivera,7,27,41,75
S3724,Alexandra Cordell,5,45,66,116
S3725,Susan Lewis,50,3,77,130
S3726,Molly Mcfall,0,21,80,101
S3727,John Killeagle,68,60,47,175
S3728,Frank Maxwell,41,4,22,67
S3729,Mark Zhu,9,24,41,74
S3730,John Gibbs,33,14,23,70
S3731,Kenneth Mccullar,82,29,94,205
S3732,Jessica Helms,3,52,71,126
S3733,Constance Garvey,84,74,28,186
S3734,Mathew Kindig,14,0,36,50
S3735,Frederick Amundson,56,78,44,178
S3736,Andrew Callahan,31,86,20,137
S3737,Larisa Hernandez,58,81,94,233
S3738,Myra Cyr,46,63,97,206
S3739,Lisa Whitfield,21,21,11,53
S3740,James Hinson,2,72,59,133
S3741,Juanita Olmos,58,38,86,182
S3742,Michael Frazier,0,59,3,62
S3743,Mona Kline,45,77,54,176
S3744,Caren Simas,48,34,83,165
S3745,Kristin Williams,27,67,74,168
S3746,Marc Marx,34,41,34,109
S3747,Tracy Luker,100,6,17,123
S3748,Jeanne Vandenberg,42,18,18,78
S3749,Dorothy Beltz,41,67,70,178
S3750,Maria Villegas,80,75,64,219
S3751,Mario Matthews,39,97,14,150
S3752,William Higginson,74,31,1,106
S3753,Jerry Pettway,81,34,93,208
S3754,Annette Barnes,79,38,5,122
S3755,Kenneth Jephson,16,54,73,143
S3756,Ronald Matthews,83,53,65,201
S3757,Brandon Berry,10,65,75,150
S3758,Darla Thacker,18,48,73,139
S3759,John Teel,8,0,32,40
S3760,Danelle Preston,93,77,59,229
S3761,Janice Perez,76,56,59,191
S3762,Amanda Scott,43,20,68,131
S3763,Casey Fitzgerald,17,16,81,114
S3764,William Volz,90,33,69,192
S3765,Rick Caudill,21,14,28,63
S3766,Gwendolyn Kroes,85,42,54,181
S3767,William Perez,60,50,19,129
S3768,Richard Roldan,19,43,84,146
S3769,Fermin Brill,68,28,38,134
S3770,Linda Hamby,65,88,43,196
S3771,Cheryl Bruce,91,32,10,133
S3772,Joseph Seeholzer,56,40,36,132
S3773,Karen Frizzell,57,23,36,116
S3774,Anna Downs,82,21,93,196
S3775,Nicole Hobbs,54,96,18,168
S3776,Patricia Crawford,48,43,62,153
S3777,Vincent Underwood,67,99,76,242
S3778,Dixie Ainsworth,28,75,12,115
S3779,Thomas Rein,91,96,51,238
S3780,Jeffrey Bailey,45,93,24,162
S3781,Diane Mitchell,98,64,98,260
S3782,John Sellers,3,61,32,96
S3783,Manuel Gingras,53,12,74,139
S3784,Cliff Rojas,15,30,87,132
S3785,Hector Linzan,38,2,70,110
S3786,Philip Johnson,60,46,88,194
S3787,Charles Fernandez,60,86,49,195
S3788,Alexis Devenport,66,4,34,104
S3789,Eleanor Phillips,22,16,25,63
S3790,Tammy Jamili,8,17,60,85
S3791,Mark Richie,89,72,38,199
S3792,Daniel Payne,1,89,52,142
S3793,Pearl Cobb,73,77,32,182
S3794,Donald Singletary,44,93,87,224
S3795,Alana Day,88,34,27,149
S3796,Matthew Potts,28,92,12,132
S3797,Tobias Clark,41,35,59,135
S3798,Rafael Kennedy,0,59,34,93
S3799,John Rivers,98,77,6,181
S3800,Norma Debarros,9,26,85,120
S3801,Jennifer Williams,39,34,88,161
S3802,Margaretta Ward,11,52,37,100
S3803,Yolanda Brecht,6,31,35,72
S3804,Bernice Rodrigues,72,68,44,184
S3805,Sam Nolan,68,62,24,154
S3806,Calvin Canady,82,70,20,172
S3807,Lena Mackson,32,72,91,195
S3808,William Johnson,13,86,92,191
S3809,Lawerence Virgil,82,79,95,256
S3810,Isaac Pearsall,50,92,61,203
S3811,Millie Kasahara,89,33,48,170
S3812,Donna Eschen,34,43,37,114
S3813,Gilberto Cochran,29,85,6,120
S3814,Elizabeth Adams,76,57,68,201
S3815,Ricardo Burkhart,85,11,58,154
S3816,Daryl Murdock,15,63,13,91
S3817,Verna Jackson,2,12,65,79
S3818,James Augustine,88,29,26,143
S3819,Amber Rodriguez,27,80,96,203
S3820,Helen Dunston,95,30,12,137
S3821,Doris Lawrence,66,72,77,215
S3822,Manuela Williams,3,68,36,107
S3823,David Lozano,39,36,92,167
S3824,Stephanie Sullivan,39,37,13,89
S3825,Heather Pecanty,24,79,72,175
S3826,Clifton Hayzlett,72,20,65,157
S3827,James Cruz,48,24,89,161
S3828,Everett Luna,12,78,88,178
S3829,Kathleen Defranco,3,28,13,44
S3830,Lisa Keisler,50,48,71,169
S3831,Arthur Mccoy,76,82,82,240
S3832,Tammy Ferraraccio,19,66,42,127
S3833,Gladys Bryant,93,57,8,158
S3834,Martha Campbell,44,70,90,204
S3835,Beverly Dansby,70,37,77,184
S3836,Michael Graff,10,24,90,124
S3837,Susie Brewster,86,54,93,233
S3838,Charlie Thruston,26,75,4,105
S3839,Jean Hayes,15,49,52,116
S3840,Cynthia Davis,51,68,55,174
S3841,Barbara Russo,72,10,63,145
S3842,David Parker,98,71,75,244
S3843,Greg Miller,56,20,6,82
S3844,Collette Meek,31,81,94,206
S3845,Linda Kubesh,90,13,69,172
S3846,Mark Aadland,5,82,80,167
S3847,Andre Shortell,44,44,43,131
S3848,Daniel Thomas,94,31,62,187
S3849,Adriana Keating,47,56,11,114
S3850,Devon Delariva,79,92,63,234
S3851,Jada Linehan,9,41,61,111
S3852,Wai Mcclard,67,12,31,110
S3853,Mitchell Browning,73,68,60,201
S3854,Sally Guerra,72,7,9,88
S3855,Fred Stacey,46,79,48,173
S3856,Louise Kettler,78,61,95,234
S3857,Doris Choi,55,62,51,168
S3858,Antoinette Amos,10,66,71,147
S3859,Ruby Gilbert,69,34,9,112
S3860,Kenneth Shultz,38,21,24,83
S3861,Tamara Hart,83,13,15,111
S3862,Minerva Wells,13,33,96,142
S3863,Kennith Huerta,70,92,90,252
S3864,Susan Jordan,64,26,33,123
S3865,Alethia Garcia,64,15,99,178
S3866,Willie Oneil,44,79,100,223
S3867,Robert Smith,93,76,22,191
S3868,Jane Scott,60,4,90,154
S3869,Richard Shakir,14,86,38,138
S3870,Ted Taylor,59,27,83,169
S3871,Michael Vasquez,36,41,66,143
S3872,Larry Hull,46,23,81,150
S3873,Cindy Davis,70,56,74,200
S3874,Kathryn Strassel,42,22,87,151
S3875,Stephanie Wible,95,21,81,197
S3876,Avery Amadon,33,61,85,179
S3877,Tonya Carpenter,8,28,7,43
S3878,Joanne Hutchinson,2,48,27,77
S3879,Ruth Favero,10,74,44,128
S3880,Cheryl Bunting,60,70,12,142
S3881,Lourdes Brockway,17,96,72,185
S3882,Valeria Harrison,92,38,50,180
S3883,Walter Kolling,57,78,25,160
S3884,Jerald Printup,67,87,68,222
S3885,Albert Fisher,70,22,19,111
S3886,Marion Colman,87,27,76,190
S3887,David Brantley,39,9,56,104
S3888,Michael Durr,48,86,92,226
S3889,Janie Brotherton,77,55,99,231
S3890,Betty May,31,62,29,122
S3891,Angelia Chambers,73,26,42,141
S3892,Emma Rocha,83,47,49,179
S3893,Lucille Spry,5,34,88,127
S3894,Joseph Kreisher,95,23,54,172
S3895,Pamela Vanhorn,17,38,25,80
S3896,Aaron Miller,98,29,93,220
S3897,Rose Hodak,35,92,34,161
S3898,David Maggio,19,83,55,157
S3899,Iva Clark,23,77,3,103
S3900,Latoya Stoeger,87,54,24,165
S3901,Roslyn Cohran,23,10,33,66
S3902,Jacques Warren,80,86,95,261
S3903,Ava Smith,26,94,54,174
S3904,Marco Richardt,39,16,14,69
S3905,Tammy Elliot,50,25,35,110
S3906,Mary Whitty,48,48,67,163
S3907,Molly Underdown,31,67,49,147
S3908,Lola Prine,13,46,37,96
S3909,Gayle Boulanger,69,37,36,142
S3910,James Avery,17,100,50,167
S3911,Jorge Reeder,0,78,66,144
S3912,Mary Baker,6,0,56,62
S3913,Deann Knudsen,65,23,58,146
S3914,Fay Smith,72,58,87,217
S3915,Nichole Soderlund,43,70,63,176
S3916,Peter Campbell,4,86,11,101
S3917,Kathleen Maryland,51,83,87,221
S3918,Robert Fierro,10,90,43,143
S3919,Felisa Lopez,19,36,23,78
S3920,Herbert Roy,81,74,17,172
S3921,Mildred Munoz,42,92,36,170
S3922,Ricardo Powers,69,6,6,81
S3923,Justin Dipietro,38,57,32,127
S3924,Autumn Huber,50,9,14,73
S3925,Lena Carter,100,6,12,118
S3926,Benjamin Mitchell,17,44,46,107
S3927,Patrick Beedle,91,78,53,222
S3928,Barbara Carter,81,57,72,210
S3929,Michael Carr,11,30,13,54
S3930,Gloria Cunningham,52,30,21,103
S3931,Norris Jackson,70,92,96,258
S3932,Grace Nawfel,2,42,42,86
S3933,Roland Andrews,3,11,62,76
S3934,Paul Chavez,95,78,66,239
S3935,Christi Velasco,45,9,67,121
S3936,Ethelyn Grullon,70,30,83,183
S3937,Dorothy Potter,67,47,65,179
S3938,Latoya Barnes,64,45,14,123
S3939,Mary Luna,35,69,63,167
S3940,Teodoro Woods,91,36,1,128
S3941,Kelly Chen,65,6,97,168
S3942,Melissa Mccauley,42,34,69,145
S3943,Jaime Upshaw,92,26,70,188
S3944,Cindy Sheridan,25,55,28,108
S3945,Allison Perkins,76,66,16,158
S3946,Leon Hatten,87,1,37,125
S3947,Danny Lacoy,13,86,8,107
S3948,John Wells,82,57,73,212
S3949,Vanessa Chance,8,5,3,16
S3950,Wilfredo Webber,41,46,12,99
S3951,Jessica Gantt,14,95,96,205
S3952,Edna Pratt,76,19,19,114
S3953,Mathew Route,78,14,48,140
S3954,Ilene Malton,66,88,12,166
S3955,Angelo Felton,15,10,95,120
S3956,Sonya Dietz,94,69,55,218
S3957,Daryl Crawford,21,97,83,201
S3958,Chester Taylor,59,20,75,154
S3959,Martha Hinkle,75,41,25,141
S3960,Sherman Pratt,84,100,90,274
S3961,Carmen Jordan,60,62,13,135
S3962,Beverly Chase,26,2,31,59
S3963,John Wright,71,19,21,111
S3964,Quentin Mcnicholas,12,33,47,92
S3965,William Fernandez,96,84,54,234
S3966,Dane Flores,68,9,52,129
S3967,Terri Ingram,35,68,5,108
S3968,Cynthia London,3,85,95,183
S3969,Mary Ternullo,35,68,61,164
S3970,Shannon Schuld,85,53,33,171
S3971,Gilbert Bilski,47,54,42,143
S3972,Ruth Rhyne,14,58,51,123
S3973,Marcie Burr,40,56,57,153
S3974,Dorothy Craig,91,40,44,175
S3975,Paul Sweitzer,89,76,98,263
S3976,Jessica Raynor,72,79,55,206
S3977,Rachael Taylor,77,24,22,123
S3978,Keith Arnesen,47,61,84,192
S3979,Keith Striplin,32,49,28,109
S3980,Bruce Metz,43,14,39,96
S3981,Helen Riche,85,32,20,137
S3982,Joshua Donnell,2,42,91,135
S3983,Jean Clarke,9,79,5,93
S3984,Dora Wright,2,74,73,149
S3985,Yajaira Vogt,76,33,9,118
S3986,Margie Denning,18,10,64,92
S3987,Vanessa Poncedeleon,79,91,65,235
S3988,Leroy King,76,71,30,177
S3989,William Madison,64,87,28,179
S3990,Randall Crews,46,58,64,168
S3991,Deborah Collins,53,44,77,174
S3992,Kathleen Stowers,51,58,21,130
S3993,Juan Spillman,6,10,24,40
S3994,Owen Otoole,55,93,50,198
S3995,Amy Pettit,61,91,36,188
S3996,Paul Boone,22,83,75,180
S3997,Michael Krebs,74,46,11,131
S3998,Linda Wrubel,94,51,78,223
S3999,Jason Adams,73,0,40,113
S4000,Christina Martinez,71,4,42,117
S4001,Hector Starke,46,92,86,224
S4002,Tempie Bond,20,36,11,67
S4003,James Glover,62,37,78,177
S4004,Douglas Jarrell,3,21,61,85
S4005,Lisa Starks,12,91,78,181
S4006,Lewis Monroe,49,2,58,109
S4007,Michael West,25,15,16,56
S4008,Jacob Duke,63,97,88,248
S4009,Delmer Haney,76,51,47,174
S4010,Carol Meachen,74,29,88,191
S4011,Georgie Hubbert,95,91,76,262
S4012,George Pitts,80,24,93,197
S4013,Lorna Beasley,44,29,49,122
S4014,Robert Miller,48,24,28,100
S4015,Aaron Crouch,18,51,11,80
S4016,Michael Moya,52,74,40,166
S4017,Beth Gargiulo,40,99,64,203
S4018,Candy Cuevas,38,74,21,133
S4019,Helen Wall,99,14,39,152
S4020,Lillian Marquez,45,61,46,152
S4021,Beverly Himes,21,47,97,165
S4022,Robert Kridel,17,45,56,118
S4023,Donald Brzozowski,82,36,44,162
S4024,Robert Vincent,90,23,70,183
S4025,Diane Barrows,81,41,19,141
S4026,Tamara Daniels,31,17,27,75
S4027,Lori Stone,0,58,71,129
S4028,Nilda Bruce,55,55,56,166
S4029,Alexander Garris,70,30,54,154
S4030,John Cook,41,68,35,144
S4031,Gracie Gabriel,29,77,52,158
S4032,Betty Bassani,74,29,46,149
S4033,Edward Snowden,74,5,41,120
S4034,Eileen Diaz,77,67,88,232
S4035,Gloria Horrocks,85,23,89,197
S4036,Charles Cole,84,86,65,235
S4037,Danyell Lloyd,8,15,91,114
S4038,Charlie Russell,67,26,53,146
S4039,Wesley Carey,55,64,22,141
S4040,David Gallegos,33,9,33,75
S4041,Goldie Thompson,12,73,13,98
S4042,Jason Maroun,94,9,57,160
S4043,Lena Delisa,6,29,75,110
S4044,Hyacinth Spencer,80,79,29,188
S4045,Sondra Barraza,54,31,71,156
S4046,Sheri Hefferon,44,34,26,104
S4047,Mildred Anthony,71,74,53,198
S4048,Gary Tomes,35,55,37,127
S4049,Herbert Andres,40,6,95,141
S4050,Amanda Nelson,19,99,25,143
S4051,William Rylee,43,80,31,154
S4052,Grace Freeman,74,36,87,197
S4053,John Casey,59,31,3,93
S4054,Tommy Tipton,57,69,83,209
S4055,Robin Few,12,56,69,137
S4056,June Mao,19,59,41,119
S4057,Frank Lopez,3,31,18,52
S4058,Margaret Irwin,78,40,25,143
S4059,Eva Sherrill,99,63,7,169
S4060,Mary Shell,89,55,84,228
S4061,Mary Garcia,53,40,83,176
S4062,George Wolfe,0,54,22,76
S4063,Ola Caskey,72,26,58,156
S4064,Donna Cervantes,7,72,45,124
S4065,Samuel Jones,54,5,11,70
S4066,Patricia Alvarez,61,57,70,188
S4067,Shannon Quesada,72,25,91,188
S4068,Ivory Everett,76,80,30,186
S4069,Amanda Guerrero,3,18,84,105
S4070,Betty Corcoran,95,43,63,201
S4071,Robyn Rood,18,29,65,112
S4072,Bonnie Hysmith,56,10,5,71
S4073,Lisa Adami,14,44,43,101
S4074,Dustin Rustin,42,68,28,138
S4075,Steve Wheeler,66,64,33,163
S4076,Sharon Leonard,50,98,68,216
S4077,Gerda Leos,77,47,9,133
S4078,Charles Delgadillo,54,49,86,189
S4079,Cheryl Hong,0,54,53,107
S4080,Richard Felder,45,56,82,183
S4081,Jesse Goforth,41,2,66,109
S4082,Thomas Garcia,17,59,66,142
S4083,Kelly Dey,84,54,41,179
S4084,Donna Lindsey,25,66,54,145
S4085,Terry Hewins,9,15,94,118
S4086,Harold Foster,86,14,21,121
S4087,Lois Cutler,81,38,31,150
S4088,Johnnie Ramos,10,62,15,87
S4089,William Burch,23,68,66,157
S4090,Alex Hellard,92,40,51,183
S4091,Vivian Mcdaniel,35,7,38,80
S4092,Paul Black,48,43,45,136
S4093,Christine Mcintosh,75,99,9,183
S4094,Rachel Beyer,5,94,79,178
S4095,Carolyn Roebuck,23,89,61,173
S4096,Christina Alvarez,88,96,48,232
S4097,Mary Vincent,32,98,31,161
S4098,Mary Roberts,29,11,12,52
S4099,Trisha Hill,80,1,35,116
S4100,Jonathan Bergsma,4,65,26,95
S4101,Joan Decourcey,97,78,87,262
S4102,Maureen Bryan,63,40,82,185
S4103,Lisa Womack,93,100,24,217
S4104,Mark Finley,71,56,34,161
S4105,Frieda Packwood,44,79,46,169
S4106,Phillip Gustafson,85,21,85,191
S4107,Ella Olivo,18,77,65,160
S4108,Meredith Wilson,91,29,12,132
S4109,Hazel Owen,75,54,21,150
S4110,Horace Boyd,34,76,49,159
S4111,Rosa Mosconi,100,5,95,200
S4112,Edward Young,91,97,63,251
S4113,Tony Rae,29,55,60,144
S4114,Ian Pinette,56,23,66,145
S4115,Danny Blalock,71,6,98,175
S4116,Ryan Martin,72,13,23,108
S4117,Clarence Court,12,70,97,179
S4118,Valerie Young,78,36,75,189
S4119,Katherine Jacobsen,83,45,1,129
S4120,Maria Schneider,50,29,20,99
S4121,Patricia Faubion,37,1,48,86
S4122,Alvin Becerra,99,82,42,223
S4123,Clayton Schmidt,54,33,70,157
S4124,Virginia Wilson,82,55,89,226
S4125,Arthur Pillow,72,31,5,108
S4126,Michelle Calvin,6,42,38,86
S4127,Debra Bristol,44,66,13,123
S4128,Alice Hicks,85,4,6,95
S4129,Nathan Rakes,14,10,80,104
S4130,Jon Tate,65,44,24,133
S4131,Jenifer Collins,58,67,31,156
S4132,Herbert Head,62,78,65,205
S4133,Jacinto Reid,30,69,59,158
S4134,Matthew Hutto,53,34,23,110
S4135,John Washington,30,63,66,159
S4136,Burton Bowen,70,33,85,188
S4137,Precious Shallenberger,2,43,35,80
S4138,Virginia Brogan,21,43,62,126
S4139,Erin Zachary,35,46,46,127
S4140,Victoria Peck,94,81,39,214
S4141,Fred Parker,4,68,29,101
S4142,Iva Long,70,57,21,148
S4143,Joellen Lynch,31,44,5,80
S4144,Justin Newton,11,58,30,99
S4145,Margaret Banks,97,83,55,235
S4146,Christopher Yard,26,26,44,96
S4147,Mark Clarke,19,64,99,182
S4148,Jason Hall,88,56,57,201
S4149,Jeanne Schwenk,16,3,51,70
S4150,Edward Budney,65,11,77,153
S4151,Miranda Mcconnell,12,79,43,134
S4152,Richard Wells,24,69,16,109
S4153,Albert Houghtaling,82,88,55,225
S4154,Pedro White,71,17,45,133
S4155,Gregory Coffelt,30,90,67,187
S4156,Millard Moore,60,25,13,98
S4157,James Jackson,6,88,13,107
S4158,Cynthia Robinson,8,34,4,46
S4159,Hubert White,31,73,43,147
S4160,Effie Cormier,83,54,28,165
S4161,Jeff Rocha,53,24,65,142
S4162,Bobby Oswald,89,83,80,252
S4163,Lovie Sherman,46,70,25,141
S4164,Anthony Garcia,89,51,42,182
S4165,Kimberly Payton,10,31,48,89
S4166,Mary Alcorn,34,55,33,122
S4167,Maria Apaez,15,67,67,149
S4168,Deborah Bos,89,92,85,266
S4169,Mark Solorzano,4,15,79,98
S4170,Thomas Wright,15,4,55,74
S4171,Tammy Walker,40,92,85,217
S4172,Margarita Hollingshead,11,38,67,116
S4173,Brenda Harris,70,97,52,219
S4174,Emily Metzler,88,5,79,172
S4175,Margart Jackson,48,2,48,98
S4176,Donald Carver,76,40,24,140
S4177,James Garcia,15,4,28,47
S4178,Dorothy Chow,47,71,89,207
S4179,Harvey Chaney,84,51,51,186
S4180,Pamela Acevedo,85,6,0,91
S4181,Clara Henderson,71,23,45,139
S4182,Wade Lowry,56,31,74,161
S4183,Wayne Dublin,90,7,38,135
S4184,Brady Turkel,94,49,84,227
S4185,Katie Marshall,13,93,35,141
S4186,William Maple,77,88,13,178
S4187,Fernando Pierce,17,51,35,103
S4188,Josephine Olson,17,68,5,90
S4189,Michael Carpenter,22,10,4,36
S4190,Mary Schiano,78,45,2,125
S4191,Craig Matthewson,70,29,98,197
S4192,Erica Brown,73,15,10,98
S4193,Rose Suehs,43,84,38,165
S4194,Velvet Johnson,63,0,13,76
S4195,Ronald Riley,68,19,96,183
S4196,Lori Singh,75,36,14,125
S4197,Sonya Hills,31,88,85,204
S4198,John Brown,9,43,12,64
S4199,Carole Hallowell,52,9,94,155
S4200,James Gonzalez,41,74,19,134
S4201,Elmer Buckland,58,59,47,164
S4202,Rhonda Sheridan,34,12,50,96
S4203,Rebecca Malek,16,54,51,121
S4204,Doris Heitman,89,61,41,191
S4205,Regina Higuera,20,91,41,152
S4206,Phil Andrade,64,95,6,165
S4207,Ronald Cooper,61,28,61,150
S4208,Tiffany Owens,35,2,64,101
S4209,Deborah Takahashi,75,80,35,190
S4210,Simone Trader,42,48,47,137
S4211,Jill Ray,39,98,1,138
S4212,Lisa Hernandez,12,100,98,210
S4213,Harold Henslee,3,6,77,86
S4214,Sara Bailey,27,50,98,175
S4215,Nancy Goldsmith,98,62,98,258
S4216,Katherine Wingate,69,43,67,179
S4217,Thomas Miles,55,75,4,134
S4218,Leslie Byers,74,12,3,89
S4219,Melissa Campos,68,92,71,231
S4220,Charles Vizcarrondo,69,7,10,86
S4221,Albert Hodge,83,44,48,175
S4222,George Magana,81,4,17,102
S4223,John Finley,34,13,68,115
S4224,Nancy Ardon,18,19,25,62
S4225,Ann Smith,95,22,60,177
S4226,Sarah Chambers,85,88,85,258
S4227,Charlie Canady,58,32,0,90
S4228,Christine Lamont,25,68,63,156
S4229,Frankie Heishman,76,65,2,143
S4230,Katie Cantrell,26,14,100,140
S4231,Jennifer Worley,45,14,73,132
S4232,Kenneth West,52,65,71,188
S4233,Nadine Mccrimmon,2,4,98,104
S4234,Joan Honse,23,21,0,44
S4235,Albert Randolph,62,55,63,180
S4236,Mae Schoonover,65,22,91,178
S4237,Carol Lee,32,82,88,202
S4238,Monique Reid,19,98,83,200
S4239,Wanda Jones,32,45,78,155
S4240,Earl Johnson,43,54,17,114
S4241,Jonathan Averette,10,80,15,105
S4242,Joan Watt,39,82,91,212
S4243,Alica Romo,91,52,58,201
S4244,Ken Pruitt,66,78,47,191
S4245,Ashley Martinez,11,49,51,111
S4246,Jennifer Hope,95,30,75,200
S4247,Kevin Patel,97,67,13,177
S4248,Stephen Landreth,15,75,52,142
S4249,Michael Furlong,25,4,20,49
S4250,Barbara Marbley,99,56,65,220
S4251,Amanda Gritton,64,61,27,152
S4252,John Roussel,68,78,1,147
S4253,Cynthia Credle,27,89,26,142
S4254,Chuck Sumner,17,4,78,99
S4255,Dennis Leingang,29,14,39,82
S4256,Douglas Gonzales,41,58,13,112
S4257,Barbara Mattos,23,100,31,154
S4258,Magdalena Collins,25,20,77,122
S4259,Suzanne Miller,14,12,78,104
S4260,George Hooper,55,4,18,77
S4261,Janelle Russell,59,90,14,163
S4262,Jerry Lavoie,14,41,40,95
S4263,Vernon Stgermain,13,33,3,49
S4264,Earnest Miller,23,84,89,196
S4265,Leroy Markel,35,79,99,213
S4266,Mark Latson,55,7,47,109
S4267,Paul Diaz,68,86,61,215
S4268,Bruce Mason,65,99,89,253
S4269,Heidi Smith,0,18,51,69
S4270,Wesley Kirkham,56,92,3,151
S4271,Christine Cruz,59,88,10,157
S4272,George Plummer,21,84,66,171
S4273,Tammy Welsh,12,8,63,83
S4274,John Smith,74,92,73,239
S4275,Jill Squires,8,99,39,146
S4276,Julia Woodruff,84,51,71,206
S4277,Mark Houston,71,33,32,136
S4278,William Lewis,80,30,80,190
S4279,James Vaughn,9,65,36,110
S4280,Todd Holmes,80,31,73,184
S4281,Cynthia Pennebaker,52,34,84,170
S4282,David Finchum,75,51,95,221
S4283,Larry King,8,87,8,103
S4284,Katherine Cruz,22,70,19,111
S4285,Melanie Rosenau,31,33,97,161
S4286,Karen Creswell,59,61,96,216
S4287,Ernesto Ward,28,64,53,145
S4288,Dana Bartels,16,51,71,138
S4289,Hollis Everett,57,74,33,164
S4290,Ella Tate,61,4,67,132
S4291,Jose Newman,2,80,96,178
S4292,Gloria Moniz,49,29,89,167
S4293,Aaron Nickelson,50,95,9,154
S4294,George Mankowski,55,91,82,228
S4295,Annette Martel,54,14,21,89
S4296,Louis Benoit,15,60,19,94
S4297,Dora Parker,60,71,24,155
S4298,Mark Chapman,69,16,16,101
S4299,George Locke,50,97,0,147
S4300,Eddie Hamblin,34,32,74,140
S4301,John Soukup,23,63,25,111
S4302,Gerald Coward,20,8,67,95
S4303,Gaye Shelton,44,35,54,133
S4304,Zachary Petrovich,48,20,80,148
S4305,Eva George,89,61,67,217
S4306,Theresa Vicente,32,31,97,160
S4307,Tracey Swenson,3,37,81,121
S4308,Sandra Church,97,26,51,174
S4309,Connie Gilmore,37,5,87,129
S4310,Frederick Merritt,29,99,0,128
S4311,Terry Bossler,100,33,93,226
S4312,Wayne Flores,21,92,65,178
S4313,Janet Villegas,90,61,18,169
S4314,Margaret Porter,100,70,73,243
S4315,Hollie Berrios,20,38,5,63
S4316,Carol Castillo,24,33,2,59
S4317,Wendy West,2,23,91,116
S4318,Martin Rodriguez,40,15,45,100
S4319,Viola Acoff,57,38,39,134
S4320,Michelle White,40,47,30,117
S4321,Sam Myers,13,19,12,44
S4322,Timothy Lacy,91,18,76,185
S4323,Louise Dyer,48,21,76,145
S4324,Vicki Ruiz,86,62,20,168
S4325,Cody Tallant,78,57,29,164
S4326,David Westley,23,97,17,137
S4327,Paige Jernigan,53,16,78,147
S4328,Irene Silva,75,20,95,190
S4329,Rosalinda Vineyard,70,60,23,153
S4330,Livia Willis,46,15,25,86
S4331,Ralph Maloney,35,64,63,162
S4332,David Griffin,20,69,3,92
S4333,Victor Duncan,80,35,24,139
S4334,Sam Brown,26,94,78,198
S4335,Carissa Wilson,53,4,50,107
S4336,Frances Lunn,82,29,55,166
S4337,Ted Uerkwitz,42,87,95,224
S4338,Anthony Mack,13,75,56,144
S4339,Rita Parks,54,67,90,211
S4340,Mary Mckeller,37,13,37,87
S4341,Charles Scherrer,90,73,20,183
S4342,Joy Darling,54,69,67,190
S4343,Julianne Burgess,69,96,4,169
S4344,John Mcalvain,20,10,74,104
S4345,Dominic King,94,38,48,180
S4346,Lori Toner,54,36,38,128
S4347,Barbara Dykstra,87,82,30,199
S4348,Eugene Hernandez,14,69,26,109
S4349,Frances Smith,17,80,18,115
S4350,Brenda Gonzalez,2,23,57,82
S4351,William Stewart,5,77,76,158
S4352,Gary Smith,31,38,0,69
S4353,Christy Casey,36,80,41,157
S4354,Sean Collier,28,34,57,119
S4355,Richard Cumming,94,78,45,217
S4356,Eric Powell,79,29,63,171
S4357,Rochelle Glover,37,18,72,127
S4358,Lauri Bigelow,97,65,19,181
S4359,Thomas Bacon,16,19,18,53
S4360,Lura Ward,91,23,12,126
S4361,James Noakes,33,17,16,66
S4362,Zoe Mcknight,24,91,54,169
S4363,Christopher Hobbs,10,72,14,96
S4364,Kathleen Barnes,89,23,9,121
S4365,Terri Ellis,56,86,9,151
S4366,Henry Herriman,47,11,68,126
S4367,Elizabeth Gamache,31,63,94,188
S4368,Marion Landefeld,71,59,32,162
S4369,Sandra Woodruff,30,75,3,108
S4370,Antoinette Diaz,76,24,99,199
S4371,Carol Huntington,87,41,11,139
S4372,Warren Backlund,43,32,74,149
S4373,Darnell Horton,70,79,33,182
S4374,Chris Darden,6,47,21,74
S4375,Marilyn Roden,86,24,29,139
S4376,Anna Hawkins,44,20,72,136
S4377,Pearl Backus,13,94,97,204
S4378,Lanie Chilson,2,27,96,125
S4379,James Andrews,11,5,64,80
S4380,Frank Hamilton,87,13,12,112
S4381,James Smith,23,32,74,129
S4382,Debbie Carney,6,18,84,108
S4383,Danielle Simpkins,35,42,27,104
S4384,Christopher Macklin,52,8,38,98
S4385,Jeanne Booker,53,23,99,175
S4386,Wendy Shook,13,97,47,157
S4387,Elizabeth Gonzalez,96,35,56,187
S4388,Felix Mccluney,79,75,17,171
S4389,John Hamel,22,98,47,167
S4390,Rebecca Murphy,0,61,75,136
S4391,Robert Denning,58,77,45,180
S4392,Michael Williams,93,72,35,200
S4393,James Harris,21,3,15,39
S4394,Teresa Hamilton,60,20,15,95
S4395,Christine Campbell,71,56,15,142
S4396,Steven Gonzalez,5,26,38,69
S4397,Albert Rossbach,94,94,74,262
S4398,Paul Willier,91,20,73,184
S4399,Kenneth Stoll,50,58,71,179
S4400,Margaret Howell,99,16,83,198
S4401,Kevin Myklebust,49,38,88,175
S4402,Ernest Malina,14,91,76,181
S4403,Catherine Abbott,4,10,33,47
S4404,Elsie Baker,41,10,19,70
S4405,Margaret Buchner,76,38,80,194
S4406,Betty Mason,83,96,62,241
S4407,Earl Schultz,72,71,74,217
S4408,Mathew Williams,87,43,1,131
S4409,Roy Howlett,89,54,40,183
S4410,Michael Thurmond,20,74,8,102
S4411,David Johnson,36,44,81,161
S4412,Hazel Davis,86,17,77,180
S4413,Anthony Zuluaga,14,18,69,101
S4414,James Bender,29,94,31,154
S4415,Robert Pieratt,38,81,18,137
S4416,Stephen Davis,80,24,67,171
S4417,Justin Wardell,91,24,11,126
S4418,Harold Moore,62,31,8,101
S4419,Summer Hampton,94,40,47,181
S4420,Joanne Sanders,82,9,80,171
S4421,Peggy Surgeon,77,86,41,204
S4422,Jeffery Livingston,59,68,85,212
S4423,Robert Weaver,98,93,31,222
S4424,Robert Powell,4,37,35,76
S4425,Melissa Boyce,56,27,22,105
S4426,Charlotte Acosta,87,20,87,194
S4427,Robert Buchanan,56,27,52,135
S4428,Rosa Hoagland,47,43,66,156
S4429,David Eshom,30,45,73,148
S4430,Craig Brock,80,6,76,162
S4431,Douglas Cangelosi,86,28,98,212
S4432,Rebecca Mooneyhan,94,39,42,175
S4433,Emma Kroll,2,94,30,126
S4434,Therese Byrne,79,25,71,175
S4435,Patricia Blatz,83,54,78,215
S4436,Patricia Buffkin,85,28,27,140
S4437,Frank Lindsay,83,21,52,156
S4438,David Coffin,77,82,31,190
S4439,Elena Weir,86,99,19,204
S4440,Andrew Sigmon,81,11,68,160
S4441,Joshua Franklin,49,95,58,202
S4442,Walter Stevenson,85,22,20,127
S4443,Patricia Goodrich,76,5,20,101
S4444,Hilary Reeves,92,50,4,146
S4445,Robert Leslie,72,58,38,168
S4446,Teresa Cahill,31,54,32,117
S4447,Danny Bishop,93,69,43,205
S4448,Julienne Crawford,54,34,49,137
S4449,Vilma Coons,72,29,96,197
S4450,Keith Swiger,98,98,98,294
S4451,Nina Wolfe,91,100,20,211
S4452,Jeffrey Thornton,99,88,21,208
S4453,Nicholas Stone,43,23,59,125
S4454,Nancy Bradley,43,8,60,111
S4455,Mary Mobilia,11,41,52,104
S4456,Mary Johnston,9,52,36,97
S4457,Charlotte Woods,89,53,72,214
S4458,Timothy Minor,56,91,91,238
S4459,Connie Allen,29,5,4,38
S4460,Mary Chapman,48,44,55,147
S4461,Edgar White,66,3,74,143
S4462,Patrick Smith,66,61,17,144
S4463,Debra Reardon,19,66,9,94
S4464,Ricardo Goldsmith,80,64,49,193
S4465,Doreen Slostad,63,22,9,94
S4466,Tiffany Strom,55,15,89,159
S4467,Catherine Elliott,35,78,7,120
S4468,Richard Gurwell,77,16,40,133
S4469,Traci Booth,26,65,3,94
S4470,Ernestine Thompson,3,14,7,24
S4471,Matthew Lay,99,51,51,201
S4472,Ruth Biser,68,8,50,126
S4473,John Fish,18,18,87,123
S4474,Micheal Doty,53,49,67,169
S4475,Claire Locke,71,50,15,136
S4476,Luis Berry,20,88,67,175
S4477,Bonnie Cain,31,47,32,110
S4478,Rudolph Hayes,33,84,45,162
S4479,Richard King,81,89,81,251
S4480,Juan Herrera,64,17,65,146
S4481,Lindsay Godfrey,94,70,4,168
S4482,Hector Godsey,9,63,29,101
S4483,Frederick Wineman,46,21,60,127
S4484,Tomiko Jordan,8,62,85,155
S4485,Richard Breaud,83,12,61,156
S4486,Evelyn Rosen,32,19,20,71
S4487,Karine Myles,27,27,17,71
S4488,Harry Rawlins,97,13,94,204
S4489,Franklin Mccoy,51,29,77,157
S4490,Martin Brimmage,85,55,25,165
S4491,Gabriel Sanchez,59,20,71,150
S4492,Henry Williams,61,4,71,136
S4493,Melissa Shipley,16,1,21,38
S4494,Christopher Halsey,53,73,9,135
S4495,Ronald Vanzandt,91,32,69,192
S4496,Evelyn Crowley,61,54,18,133
S4497,Dwight Flinchum,95,85,91,271
S4498,Sue Moore,12,45,58,115
S4499,Eric Moore,98,23,27,148
S4500,Orville Murray,57,50,9,116
S4501,Alexis Mcarthur,89,82,97,268
S4502,Tressie Burt,2,22,32,56
S4503,Ryan Burrows,42,45,72,159
S4504,Patsy Russo,89,58,56,203
S4505,Kenneth Yaeger,87,41,53,181
S4506,Calvin Sylvester,26,28,99,153
S4507,Robert Hernandez,32,98,46,176
S4508,David Harris,34,5,15,54
S4509,Ashley Jeansonne,76,95,63,234
S4510,Laura Herrera,92,63,19,174
S4511,John Harrison,24,68,28,120
S4512,Lewis Bowe,21,23,36,80
S4513,Mitchell Kell,99,56,20,175
S4514,Enrique Certain,1,62,77,140
S4515,Oliver Tipka,59,72,20,151
S4516,Ruth Mccormack,13,0,10,23
S4517,Laura Verdejo,87,79,44,210
S4518,Roy Cardenas,40,86,18,144
S4519,Ramonita Hodosy,4,18,71,93
S4520,Kenneth Hill,91,28,10,129
S4521,Patricia Ungaro,25,55,45,125
S4522,Alva Hays,51,15,84,150
S4523,Thomas Robinson,79,14,60,153
S4524,Alexandra Carter,63,40,5,108
S4525,Kerry Younger,21,11,9,41
S4526,Harold Owensby,39,64,19,122
S4527,Kimberly Sadler,64,96,59,219
S4528,Gussie Kerce,47,85,97,229
S4529,Rickey Lopez,35,89,41,165
S4530,Ernest Whitehead,77,77,88,242
S4531,Keith Chunn,60,78,54,192
S4532,Faye Taylor,88,72,2,162
S4533,Melissa Newton,94,73,90,257
S4534,Michael Combs,95,86,99,280
S4535,Jackie Carter,8,62,92,162
S4536,David Fujita,38,67,79,184
S4537,Robin Smtih,73,55,15,143
S4538,Kathleen Tyler,26,12,83,121
S4539,Teresa Ricker,48,95,7,150
S4540,Joyce Williams,59,79,55,193
S4541,Dustin Whitton,33,43,18,94
S4542,Lisa Barnard,98,94,20,212
S4543,Joyce Graham,42,16,82,140
S4544,Janet Rocha,3,89,52,144
S4545,Cherlyn Francis,23,10,4,37
S4546,Ruth Patz,68,84,2,154
S4547,Carlos Dansby,69,46,14,129
S4548,Jerry Campbell,71,50,2,123
S4549,Jerry Harding,51,93,49,193
S4550,Maggie Halstead,95,10,96,201
S4551,Eugene Bray,63,52,72,187
S4552,Mildred Mcgowen,4,88,26,118
S4553,Marianne Stollsteimer,46,97,50,193
S4554,Michael Rickman,17,36,70,123
S4555,Elizabeth Christenson,79,85,74,238
S4556,Karl Ernst,50,5,78,133
S4557,Joseph Striplin,95,54,39,188
S4558,Cristina Easley,8,80,0,88
S4559,Sheila Stokes,31,44,99,174
S4560,Winston Foss,73,29,75,177
S4561,Bobby Bacon,96,52,80,228
S4562,Byron Weiler,88,72,89,249
S4563,Rebecca Dwyer,95,45,47,187
S4564,Benjamin Sahara,19,7,24,50
S4565,Anthony Mcguffin,0,73,66,139
S4566,Michael Blom,95,98,47,240
S4567,Evelyn Price,85,98,68,251
S4568,Joy Dickinson,90,22,79,191
S4569,David Swoager,16,96,61,173
S4570,Isela Wun,92,66,79,237
S4571,Don Whitehead,75,63,94,232
S4572,Allene Gilchrist,52,56,63,171
S4573,Leo Moore,76,16,68,160
S4574,Brian Williams,89,38,43,170
S4575,Arturo Marshall,2,53,90,145
S4576,Heidi Palermo,7,56,64,127
S4577,Roger Carney,65,79,45,189
S4578,Theodore Brodi,60,60,90,210
S4579,Bertha Stewart,53,86,94,233
S4580,Russell Scott,32,39,85,156
S4581,Edward Westmoreland,93,56,29,178
S4582,Harry Perkins,91,82,85,258
S4583,Socorro Hollman,53,17,16,86
S4584,Janice Sproul,77,42,98,217
S4585,Ronald Jenkins,95,84,77,256
S4586,Georgia Rios,88,29,60,177
S4587,Kim Casillas,23,40,40,103
S4588,Richard Hardman,92,53,1,146
S4589,Curtis Samuels,69,82,92,243
S4590,John Hall,28,73,15,116
S4591,Christine Howard,75,18,97,190
S4592,Katelyn Rozar,46,24,75,145
S4593,Trina Hickey,59,47,78,184
S4594,Andrew Mildenberger,52,52,86,190
S4595,Stephen Cotton,98,37,89,224
S4596,Autumn Dunaway,49,18,70,137
S4597,Dale Cavanaugh,90,73,95,258
S4598,Lisa Casey,62,77,94,233
S4599,Shelby Vaughn,13,95,96,204
S4600,Doris Halls,39,24,61,124
S4601,Nicole Jones,1,88,38,127
S4602,Caroline Stevenson,34,66,66,166
S4603,Amanda Mclaughlin,67,78,66,211
S4604,Carmen Webster,90,62,95,247
S4605,Kathryn Aronson,47,87,95,229
S4606,Martin Whiteside,25,11,63,99
S4607,Fay Garcia,48,91,94,233
S4608,Becky Baker,82,81,82,245
S4609,Patrick Krieger,52,87,83,222
S4610,Rosalinda Williams,12,22,84,118
S4611,Terrell Dehart,53,18,40,111
S4612,Frank Ferrell,89,92,5,186
S4613,Joshua Servoss,62,46,46,154
S4614,James Simpson,89,45,16,150
S4615,Rosalind Weatherford,96,28,8,132
S4616,Rashad Omalley,7,30,76,113
S4617,Joshua Harwell,39,2,99,140
S4618,Jason Marti,58,36,80,174
S4619,Robert White,69,3,39,111
S4620,Richard Baldwin,61,78,20,159
S4621,Jean Davis,44,52,90,186
S4622,Arthur Enriguez,9,76,48,133
S4623,Dorthy Butterfield,68,56,11,135
S4624,Joanne Tillman,85,7,79,171
S4625,Goldie Snell,69,91,80,240
S4626,Betty Sturtz,95,24,36,155
S4627,John Hendershot,36,21,97,154
S4628,Lisa Erwin,43,75,5,123
S4629,Beatrice Chester,49,24,63,136
S4630,Justin Campbell,35,16,91,142
S4631,Doris Barrett,14,20,9,43
S4632,Andrea Men,72,79,87,238
S4633,Peter Race,74,93,97,264
S4634,Richard Richardson,59,45,38,142
S4635,Patrice Drumm,93,65,67,225
S4636,John Davis,54,96,53,203
S4637,Janae Sharpless,93,93,79,265
S4638,Helen Martinez,77,59,51,187
S4639,Donna Summers,61,50,89,200
S4640,Cathy Baker,60,89,21,170
S4641,Jeffery Scott,36,49,52,137
S4642,Barbara Martine,91,9,73,173
S4643,Tracy Lawhorn,25,37,87,149
S4644,Ashley Goss,16,25,66,107
S4645,Luella Barnett,34,68,5,107
S4646,Randall Stotts,20,39,10,69
S4647,Katheryn Greener,8,67,54,129
S4648,Dale Vu,48,80,86,214
S4649,Jimmy Jordan,37,92,80,209
S4650,Maude Blankenship,4,75,84,163
S4651,Brian Anchondo,15,86,86,187
S4652,Harold Neubauer,94,5,95,194
S4653,Clarence Knight,66,27,27,120
S4654,Henry Delgado,14,41,5,60
S4655,Lillie Guyette,51,41,89,181
S4656,Angela Turbyfill,70,81,31,182
S4657,Adrian Hunt,55,28,6,89
S4658,Keith Matthews,91,64,31,186
S4659,Nicholas Schwartz,4,70,47,121
S4660,Jayne Back,61,30,51,142
S4661,Joseph Stimpert,60,84,45,189
S4662,Bruce Bush,93,82,26,201
S4663,Jose Mccollum,0,29,68,97
S4664,Roger Ostrov,51,21,11,83
S4665,William Oliver,21,42,68,131
S4666,David Noel,55,5,44,104
S4667,Thelma Force,49,61,36,146
S4668,Alethia Faires,82,50,75,207
S4669,Scott Thomas,64,60,59,183
S4670,Jay Patrick,17,57,63,137
S4671,Imogene Cass,72,77,72,221
S4672,Johnny Schumann,24,32,10,66
S4673,Brett Ball,91,62,36,189
S4674,Marcos Walsh,39,57,75,171
S4675,Robert Juul,9,16,35,60
S4676,Jose Marschke,88,1,73,162
S4677,Richard Mack,75,29,98,202
S4678,Samuel Bascom,96,97,9,202
S4679,William Rodriguez,58,95,44,197
S4680,Irene Petersen,95,51,23,169
S4681,Florence Abramson,57,89,30,176
S4682,Martha Hughes,64,48,100,212
S4683,Rhoda Scaglione,75,10,63,148
S4684,William Miles,85,50,42,177
S4685,Kimberly Jackson,87,86,15,188
S4686,Michael Catrone,45,33,38,116
S4687,Michele Perry,100,94,61,255
S4688,James Jones,9,92,67,168
S4689,Sarah Warren,25,16,60,101
S4690,Donna Winfrey,9,23,0,32
S4691,Eva Alicea,7,15,11,33
S4692,Rafael Barnett,81,37,27,145
S4693,Henry Stockton,64,77,60,201
S4694,Nila Carmody,53,43,9,105
S4695,Brittney Elliott,29,38,65,132
S4696,Leslie Serrano,74,6,9,89
S4697,Lorena Lambert,23,99,18,140
S4698,Timothy Figueroa,32,77,20,129
S4699,Jason Darlington,40,32,15,87
S4700,Chad Dowell,21,0,97,118
S4701,Nichole Tibbetts,11,48,97,156
S4702,Dorothy Oconnor,85,32,83,200
S4703,Andre Daniels,57,59,15,131
S4704,Nathan Masser,54,67,68,189
S4705,Nancy Zoltek,25,29,11,65
S4706,Debbie Gulotta,10,36,19,65
S4707,Helen Brooks,13,53,13,79
S4708,Diane Martin,42,85,36,163
S4709,Diana Sullivan,26,63,100,189
S4710,Alice Martin,7,74,93,174
S4711,Valerie Irvine,13,42,22,77
S4712,Neil Wine,8,94,76,178
S4713,Anthony Allen,3,55,13,71
S4714,Antonio Bartels,75,79,84,238
S4715,Orville Manternach,22,25,54,101
S4716,Eduardo Fletcher,10,46,60,116
S4717,Paul Tharp,74,79,100,253
S4718,Steven Williams,7,36,51,94
S4719,Denise Fix,64,81,22,167
S4720,Julius Barnes,14,22,89,125
S4721,Karen Riley,8,16,9,33
S4722,Christine Law,84,12,17,113
S4723,Chad Gonzalez,99,93,65,257
S4724,Robert Barrett,3,0,31,34
S4725,Arthur Chapman,97,42,0,139
S4726,Ida Jones,65,30,5,100
S4727,Linda Williams,10,86,93,189
S4728,Rosa Dignan,55,37,55,147
S4729,Shawn Ruiz,76,96,14,186
S4730,Deborah Mosquera,73,85,58,216
S4731,Christopher Davis,59,65,3,127
S4732,Perry Rodriguez,34,83,94,211
S4733,Autumn Poche,69,18,49,136
S4734,Thelma Wilson,49,63,99,211
S4735,Patricia Jones,16,81,64,161
S4736,Jerry Lee,8,69,5,82
S4737,Glenn Derego,40,28,61,129
S4738,Alexa Monroe,61,20,60,141
S4739,Judy Littleton,85,81,8,174
S4740,Kathleen Kauffman,74,51,68,193
S4741,Aisha Freeman,38,33,75,146
S4742,Howard Dawes,44,17,39,100
S4743,Brian Green,71,29,97,197
S4744,Christina Woolbright,88,69,3,160
S4745,James White,90,33,82,205
S4746,Pauline Welch,49,8,18,75
S4747,Corey Temblador,88,44,24,156
S4748,Manda Ferreira,68,100,12,180
S4749,Franklin Jarvis,65,62,55,182
S4750,Deborah Marie,52,28,80,160
S4751,Sara Ward,88,100,36,224
S4752,Timothy Melton,63,27,86,176
S4753,Lillie Dun,31,30,95,156
S4754,William Purdy,82,48,74,204
S4755,Joane Gilbert,42,40,44,126
S4756,Sherman Clover,34,18,23,75
S4757,Russell Vazquez,70,69,2,141
S4758,Johnathan Childers,61,30,28,119
S4759,Amber Zima,12,90,94,196
S4760,Donald Wilkerson,90,48,23,161
S4761,Gary Goodhart,87,42,77,206
S4762,Ruth Brown,54,0,77,131
S4763,Emily Butler,45,72,21,138
S4764,Angel Killian,28,5,46,79
S4765,Jorge Hernandez,50,27,87,164
S4766,Joel Oglesby,0,29,67,96
S4767,Robert Fox,28,76,19,123
S4768,Linda Carmichael,25,71,5,101
S4769,Maria Kallam,54,95,21,170
S4770,Ora Jacobs,19,27,8,54
S4771,Jacquelyn Radigan,68,19,66,153
S4772,Jay Velez,29,45,22,96
S4773,Jeffery Hyatt,54,45,31,130
S4774,Alma Sitton,46,59,65,170
S4775,Thomas Adams,41,60,20,121
S4776,Kevin Carpenter,86,2,72,160
S4777,Byron Ibarra,71,30,76,177
S4778,Steven Carter,50,74,95,219
S4779,Carl Aleshire,36,43,36,115
S4780,Allen Syrett,21,58,60,139
S4781,Garry Mercer,18,62,27,107
S4782,Kenneth Williams,52,40,79,171
S4783,Michael Strong,55,73,30,158
S4784,Joseph Nguyen,21,55,99,175
S4785,Isabelle Mcvey,27,48,97,172
S4786,Haywood Quinn,75,69,77,221
S4787,Charles Townsend,9,41,62,112
S4788,John Sloan,17,23,39,79
S4789,Michael Mouzon,79,76,48,203
S4790,William Keller,10,77,50,137
S4791,Jonathan Rauh,43,93,29,165
S4792,Robert Suben,43,25,58,126
S4793,Dorothy Barnes,43,43,25,111
S4794,John Willhite,12,1,29,42
S4795,Claudette Newell,80,68,31,179
S4796,Tom Lopez,22,59,6,87
S4797,Ruby Torry,14,43,31,88
S4798,Sharon Bryant,67,51,1,119
S4799,Douglas Colindres,58,60,52,170
S4800,Kristi Fernandez,25,52,63,140
S4801,Michael Johnson,19,37,80,136
S4802,Jennifer Fugitt,93,80,57,230
S4803,Garry Badami,80,44,14,138
S4804,Monica Nunez,99,15,32,146
S4805,James Petrus,93,70,87,250
S4806,Rhonda Howard,90,91,82,263
S4807,Antonio Chalmers,80,78,59,217
S4808,Tracey Colson,76,76,50,202
S4809,Griselda Dills,28,50,96,174
S4810,Marcella Schlegel,95,73,12,180
S4811,Tamera Cook,50,5,68,123
S4812,Ruth King,48,96,49,193
S4813,Frank Halas,81,51,76,208
S4814,Myra Valdez,80,62,4,146
S4815,Annie Tornow,53,20,82,155
S4816,Phillip Siwicki,75,90,32,197
S4817,Candace Ballard,80,65,65,210
S4818,Joshua Anderson,79,48,43,170
S4819,Sherman Caswell,94,4,97,195
S4820,Jerry Keever,2,49,38,89
S4821,Jack Moses,94,39,64,197
S4822,Elaine Luma,5,43,2,50
S4823,Mabel Vanmeter,14,59,40,113
S4824,Mario Williams,83,72,25,180
S4825,Victoria Hale,72,72,5,149
S4826,Elsie Hardy,26,60,84,170
S4827,Charles Keys,95,14,67,176
S4828,Jeffery Santos,91,56,4,151
S4829,Martin Guerra,51,84,95,230
S4830,Michele Walden,16,56,32,104
S4831,Ida Hagler,77,48,32,157
S4832,Tyrone Kochheiser,33,57,64,154
S4833,Jack Hernandez,58,70,2,130
S4834,Diana Hummel,66,54,83,203
S4835,Ramon Pillow,28,38,82,148
S4836,Alisha Thomas,20,84,82,186
S4837,Lori Johnson,67,68,90,225
S4838,Kurt Goodwin,98,10,43,151
S4839,Leroy Oreilly,100,72,34,206
S4840,Harold Sheck,9,96,19,124
S4841,Beatriz Limoli,99,53,26,178
S4842,Kenneth Helmes,98,48,5,151
S4843,Michael Walden,50,71,85,206
S4844,Sadie Odom,53,26,2,81
S4845,Anthony Goodson,59,12,68,139
S4846,Vivian Bejaran,3,49,83,135
S4847,Alice Gest,20,29,59,108
S4848,Anna Rodriquez,15,56,65,136
S4849,Albert White,80,3,53,136
S4850,Helen Napier,70,45,90,205
S4851,Brenda Parish,13,23,96,132
S4852,Julio Rooney,66,14,44,124
S4853,Aimee Snyder,3,29,62,94
S4854,Kristen Hakes,17,0,39,56
S4855,Randy Williams,31,91,49,171
S4856,Gene Sharp,92,38,69,199
S4857,Charles Bell,11,68,29,108
S4858,Alfred Askew,97,45,75,217
S4859,Cecelia Ardito,44,80,88,212
S4860,Margaret Chiles,63,79,20,162
S4861,Nancy Bennett,34,58,90,182
S4862,Robert Hawes,7,63,19,89
S4863,Geoffrey Subido,76,56,49,181
S4864,Sandra Walker,48,1,26,75
S4865,Marge Sampson,53,12,12,77
S4866,Patricia Campbell,27,91,22,140
S4867,Elizabeth Dickinson,5,73,62,140
S4868,Lucas Nicholson,33,96,79,208
S4869,Cherry Jones,20,18,8,46
S4870,Stephen Akin,12,73,69,154
S4871,Leigh Woo,63,67,60,190
S4872,George Brick,87,7,83,177
S4873,Betsy Bates,45,29,2,76
S4874,Peter Henry,52,67,81,200
S4875,Linda Smith,51,74,7,132
S4876,Shawn Corriveau,15,74,12,101
S4877,Dean Green,73,84,14,171
S4878,Pamela Mondragon,85,76,1,162
S4879,Sharon Sinkler,65,53,92,210
S4880,Tommie Wright,41,49,11,101
S4881,Kenneth Meyer,25,45,17,87
S4882,Cynthia Griffis,10,97,76,183
S4883,Lorena Decastro,9,54,27,90
S4884,Celia Randolph,90,56,12,158
S4885,Caroline Roylance,17,59,83,159
S4886,Diana Hochstetler,87,81,21,189
S4887,Carmella Grillo,15,56,30,101
S4888,Mayra Dennison,99,75,0,174
S4889,Patrick Montgomery,28,71,44,143
S4890,Glenn Leet,35,27,30,92
S4891,Joshua Lindsey,2,98,13,113
S4892,John Bade,47,17,59,123
S4893,Max Venecia,44,34,66,144
S4894,Deborah Fang,12,59,36,107
S4895,Ingrid Baker,0,89,36,125
S4896,Adam Stitt,53,21,55,129
S4897,Mary Wright,4,34,95,133
S4898,Randall Henderson,37,38,55,130
S4899,Audry Chisum,29,83,26,138
S4900,Hosea Pendry,5,25,82,112
S4901,Lilian Voll,37,83,85,205
S4902,Heather Brewer,83,37,79,199
S4903,Mark Cantin,50,16,84,150
S4904,Donna Sylvester,34,47,39,120
S4905,Carmen Neff,54,97,59,210
S4906,Donna Mccaskin,66,60,55,181
S4907,Maude Williams,48,98,98,244
S4908,Jill Curtis,65,78,68,211
S4909,Tammy Sanchez,52,69,11,132
S4910,Robert Caggiano,33,90,75,198
S4911,Heather Seidman,93,37,65,195
S4912,David Johnson,46,24,12,82
S4913,Wendell Johann,9,45,4,58
S4914,Leon Studer,84,95,80,259
S4915,Carol Holden,64,97,8,169
S4916,Patricia Hunt,88,39,83,210
S4917,Nicole Huckaby,9,24,78,111
S4918,Dale Soto,72,7,52,131
S4919,Deborah Bruggeman,34,21,23,78
S4920,Ashley Arrowsmith,42,98,23,163
S4921,Sharon Kraus,86,96,30,212
S4922,Patrick Nunez,5,7,80,92
S4923,Enrique Hammond,16,10,40,66
S4924,Janette Diminich,63,6,47,116
S4925,Andrew Wilson,97,45,50,192
S4926,Minnie Landrum,62,58,47,167
S4927,William Johnson,11,68,97,176
S4928,Kelly Jordan,95,70,64,229
S4929,Melissa Baxter,66,4,34,104
S4930,Sean Stockton,64,4,26,94
S4931,Nancy Moriarty,8,95,28,131
S4932,Dominick Terrell,70,84,73,227
S4933,Nancy Beaudreault,77,29,23,129
S4934,Katherine Augenstein,17,28,90,135
S4935,James Jones,61,34,33,128
S4936,Andrea Kennedy,30,27,67,124
S4937,Martin Kiger,21,62,95,178
S4938,Mary Lucero,77,24,63,164
S4939,Jonathon Conner,39,74,100,213
S4940,Darrin Muir,86,74,17,177
S4941,Brandon Hunter,57,16,46,119
S4942,Kevin Baez,45,100,16,161
S4943,Reggie Adams,9,58,17,84
S4944,Stephanie Walker,56,89,81,226
S4945,Donna Montgomery,80,47,19,146
S4946,Donald Hernandez,31,92,4,127
S4947,Terry Walls,88,77,11,176
S4948,Charles Smith,30,14,42,86
S4949,Jean Siewers,92,99,12,203
S4950,Bonnie Nestor,25,97,82,204
S4951,Lorena Coles,53,31,71,155
S4952,Adam Atkinson,95,32,18,145
S4953,Joan Hedley,70,99,32,201
S4954,Matthew Reimers,88,14,13,115
S4955,Jackie Smith,4,43,98,145
S4956,Victor Mccaskill,77,98,74,249
S4957,Jason Arbeiter,78,0,70,148
S4958,Amy Taylor,79,82,39,200
S4959,Nancy Lange,71,69,14,154
S4960,Jeffrey Richards,23,25,74,122
S4961,Judy Simpson,14,84,65,163
S4962,Paul Banks,33,24,2,59
S4963,Stephen Littleton,80,58,98,236
S4964,Gregory Christie,37,44,76,157
S4965,Andrea Tommie,61,25,94,180
S4966,Carol Lamoureux,72,76,8,156
S4967,Jeffrey Huguenin,71,68,58,197
S4968,Elizabeth Cranmer,73,72,50,195
S4969,Fred Moncrief,16,55,38,109
S4970,Matthew Renaud,68,97,97,262
S4971,Donald Kurohara,4,94,100,198
S4972,Rita Delisi,58,73,25,156
S4973,Phillip Fitzpatrick,45,19,31,95
S4974,Janie Crofton,75,47,42,164
S4975,Steven Brewer,23,28,4,55
S4976,Stephanie Dickerson,49,39,22,110
S4977,Mark Abreu,21,61,59,141
S4978,Glenn Tashman,56,36,83,175
S4979,Sylvia Harrison,75,13,2,90
S4980,Rosina Twyman,38,78,77,193
S4981,Eugene Kiely,28,24,40,92
S4982,Jeffrey Sorell,56,45,80,181
S4983,Carol Pirtle,6,75,21,102
S4984,Pat Sierra,91,52,19,162
S4985,Ernest Lovell,54,10,46,110
S4986,Angelica Vega,88,79,81,248
S4987,Virginia Hodge,51,1,39,91
S4988,Carmen Kaua,92,58,47,197
S4989,Cora Laidlaw,48,86,76,210
S4990,Danielle Curci,68,54,79,201
S4991,Theresa Welborn,18,54,85,157
S4992,Milton Scott,99,21,38,158
S4993,Yolonda Myles,8,47,67,122
S4994,Gregory Redd,69,35,99,203
S4995,Brian Shirley,86,65,58,209
S4996,Timothy Johnson,3,51,20,74
S4997,John Bewley,16,96,78,190
S4998,Charles Nickens,26,51,6,83
S4999,Donna Cain,81,83,57,221
S5000,Kenneth Reyes,94,95,0,189
S5001,Lina Reyes,7,95,4,106
S5002,Jamie Bailey,53,1,12,66
S5003,Roberta Rivera,50,6,58,114
S5004,Brian Daugherty,97,30,73,200
S5005,Michael Jobe,7,89,2,98
S5006,Catherine Gardner,84,64,30,178
S5007,Barbara Rankins,25,28,86,139
S5008,Alvina Clance,16,14,21,51
S5009,Robert Stubbs,55,6,77,138
S5010,Kathy Simpson,63,31,6,100
S5011,Becky Sigg,91,96,99,286
S5012,Nicolas Johansen,4,10,7,21
S5013,Kathleen Williams,45,11,67,123
S5014,Benjamin Buchanan,27,6,20,53
S5015,Gerard Johns,84,17,25,126
S5016,Mary Ibanez,59,72,48,179
S5017,Woodrow Mccool,13,55,17,85
S5018,Woodrow Sampson,69,89,4,162
S5019,Sandra People,45,14,75,134
S5020,Perry Clark,17,5,35,57
S5021,James Woodard,95,57,62,214
S5022,Karen Ellefson,78,0,11,89
S5023,Alice Mccraken,41,46,73,160
S5024,Tonya Morris,47,100,16,163
S5025,Will Mcdavid,68,61,27,156
S5026,George Reposa,29,59,82,170
S5027,Lindsey Green,47,12,40,99
S5028,Michele Little,25,4,64,93
S5029,Jose Estes,7,25,67,99
S5030,Harold Nazario,82,56,62,200
S5031,Janice Parker,13,90,50,153
S5032,Gregory Fernandez,43,16,98,157
S5033,Julie Wright,47,44,71,162
S5034,Kevin Jaggers,57,13,59,129
S5035,Dorothy Midgette,46,13,86,145
S5036,Kaitlin Hastings,94,70,32,196
S5037,Anibal Jones,65,12,60,137
S5038,Drucilla Rutledge,35,52,64,151
S5039,Donald Philpot,83,44,100,227
S5040,Iris Barnhart,41,77,46,164
S5041,Paul Louis,23,23,44,90
S5042,Cindy Hill,83,50,0,133
S5043,Dennis Brent,38,55,31,124
S5044,Cecelia Smith,16,93,14,123
S5045,Jose Dolan,49,6,76,131
S5046,Lowell Endicott,21,64,75,160
S5047,Thomas Rodriguez,4,25,17,46
S5048,Evelyn Clement,47,60,82,189
S5049,Gary Ruivo,64,52,40,156
S5050,Samella Lynch,81,29,6,116
S5051,Pamela Shelton,62,18,93,173
S5052,Henry Moscowitz,34,97,42,173
S5053,Andres Koppenhaver,61,7,35,103
S5054,Cathy Schroer,57,26,35,118
S5055,Jimmy Manchini,84,31,95,210
S5056,Dwight Miller,40,0,54,94
S5057,Barbara Moore,10,42,1,53
S5058,Brian Eyler,39,39,6,84
S5059,Luis Lafrance,97,91,61,249
S5060,Fatima Mccall,38,77,45,160
S5061,Annette Reid,46,63,66,175
S5062,Fred Richardson,55,49,90,194
S5063,Shirley Edwards,90,22,8,120
S5064,Clarence Mclelland,74,1,75,150
S5065,Craig Barnett,57,31,19,107
S5066,Morgan Johnson,100,0,7,107
S5067,Betty Garcia,90,68,25,183
S5068,Kevin White,36,45,22,103
S5069,Fred Cadena,43,84,48,175
S5070,Taylor Beesley,13,74,62,149
S5071,Misty Shockley,38,32,88,158
S5072,Benjamin Burns,50,37,5,92
S5073,Whitney Mays,13,8,51,72
S5074,Pamela Robinson,56,13,98,167
S5075,Amie Litzenberg,61,24,67,152
S5076,William Blevins,58,30,23,111
S5077,John Richart,64,94,25,183
S5078,Anne Furrer,33,37,87,157
S5079,Carolyn Mcardle,45,49,66,160
S5080,Willie Klassen,81,62,52,195
S5081,Leandra Martin,13,6,85,104
S5082,Tamara Balderas,32,15,7,54
S5083,Richard Blackwell,1,47,13,61
S5084,John Dong,0,21,15,36
S5085,Kathryn Wright,35,40,59,134
S5086,Charles Cahill,87,99,87,273
S5087,Bernard Jackson,91,4,45,140
S5088,Benjamin Goldberg,42,88,15,145
S5089,James Gomez,90,18,25,133
S5090,Carol Warner,86,78,39,203
S5091,James Rand,84,35,32,151
S5092,Dolores Bunn,2,8,14,24
S5093,Quincy Martinez,88,96,63,247
S5094,John West,69,75,59,203
S5095,Roy Rayford,70,46,16,132
S5096,Christina Matthews,22,9,89,120
S5097,James Dixon,86,0,93,179
S5098,Domingo Blethen,58,54,7,119
S5099,Wayne Leider,45,87,88,220
S5100,Cheryl Monroe,95,71,37,203
S5101,Ronald Cloutier,45,65,29,139
S5102,Emily Jackson,90,7,97,194
S5103,Vilma Powell,44,34,56,134
S5104,Emily Stelzer,57,13,1,71
S5105,Arthur Culp,30,88,78,196
S5106,Renae Demaio,89,15,54,158
S5107,Violeta Jasper,4,85,43,132
S5108,Tyrone Baker,12,61,11,84
S5109,Gloria Thompson,7,98,46,151
S5110,Katherine Castano,48,94,24,166
S5111,Barry Warren,1,25,100,126
S5112,Latisha Hayes,54,5,55,114
S5113,Amanda Battles,62,64,35,161
S5114,Teresita Nelson,18,13,64,95
S5115,Kimberly Beatty,4,21,41,66
S5116,Debra Andrews,40,92,33,165
S5117,Merilyn Behrens,92,59,84,235
S5118,Addie Collini,93,89,91,273
S5119,Jean Halvorson,6,58,1,65
S5120,John Berry,15,75,75,165
S5121,Russell Smith,17,23,15,55
S5122,Brenda Brown,25,52,74,151
S5123,Michael Smith,29,37,44,110
S5124,Sandra Duncan,49,11,34,94
S5125,Alexander Hayes,74,50,80,204
S5126,John Baker,90,60,35,185
S5127,Joseph Most,22,23,23,68
S5128,Donya Grigg,60,34,23,117
S5129,Larry Dooley,47,11,14,72
S5130,Janice Johnson,95,62,21,178
S5131,Kimberly Sylvester,39,66,44,149
S5132,Eric Cross,10,21,25,56
S5133,Nathanial Minnick,17,58,25,100
S5134,Christopher Whitley,32,99,85,216
S5135,John Pratt,17,34,89,140
S5136,Arnold Davis,51,10,8,69
S5137,Millard Davis,1,67,52,120
S5138,Richard Sumney,46,64,81,191
S5139,Paul Camacho,80,48,98,226
S5140,Edna Anderson,37,16,91,144
S5141,Brandy Toombs,79,4,61,144
S5142,Arthur Reagan,99,6,17,122
S5143,Yvonne Velasco,6,90,7,103
S5144,Barbara Roberson,67,85,78,230
S5145,Doris Moore,14,6,34,54
S5146,Robert Gore,25,100,47,172
S5147,Andrew Laurent,94,77,11,182
S5148,Christine Hodgson,79,52,49,180
S5149,Terry Robertson,22,1,18,41
S5150,Bernard Sumney,11,58,3,72
S5151,Arlene Rule,87,97,24,208
S5152,Elizabeth Halpern,100,14,18,132
S5153,Jesenia Christensen,19,29,66,114
S5154,Marilyn Hamilton,94,94,68,256
S5155,Katie Halvorson,64,14,43,121
S5156,Yolanda Drury,1,29,64,94
S5157,Nancy Cohen,31,86,52,169
S5158,Shayne Hernandez,98,31,64,193
S5159,Wilma Fluitt,28,39,56,123
S5160,Everett Sipe,20,18,100,138
S5161,Caroline Fairfax,40,41,22,103
S5162,Judy Woodard,81,57,65,203
S5163,Vernon Jarman,48,80,55,183
S5164,Glenda King,55,13,39,107
S5165,Laura Chaires,2,51,23,76
S5166,Alfred Michalski,29,47,55,131
S5167,Nelida Coon,71,29,97,197
S5168,Wayne Walters,51,18,12,81
S5169,David Cox,90,36,73,199
S5170,Anna Rieth,53,49,100,202
S5171,Warren Allison,74,68,28,170
S5172,John Kaneta,11,22,77,110
S5173,Greg Miller,26,3,48,77
S5174,Sandra Proctor,14,90,5,109
S5175,Dale Neel,59,36,65,160
S5176,Clifford Freeman,78,71,68,217
S5177,Brandon Hollomon,29,34,75,138
S5178,Andrew Little,82,67,90,239
S5179,Sherri Kerr,11,58,85,154
S5180,Michael Matthew,39,58,30,127
S5181,Larry Nash,30,14,12,56
S5182,Julian Williams,25,38,11,74
S5183,Rex Halm,94,27,50,171
S5184,Teresa Johnson,99,19,72,190
S5185,Cortney Hall,28,51,93,172
S5186,John Raab,88,36,76,200
S5187,Lucille Reader,7,17,5,29
S5188,Mark Matson,95,3,87,185
S5189,Bobby Castillo,27,7,100,134
S5190,Catherine Bowles,48,7,7,62
S5191,Tommy Hernandez,51,22,50,123
S5192,Doreen Snow,44,24,9,77
S5193,Jose Box,96,71,81,248
S5194,Dorothy Harris,99,86,9,194
S5195,Wesley Smart,20,30,67,117
S5196,Jody Boniello,11,63,49,123
S5197,William Cash,82,56,79,217
S5198,Brandon Lofton,96,54,53,203
S5199,Kevin Sires,46,93,64,203
S5200,Willie Patterson,71,2,70,143
S5201,Jean Rubio,11,47,54,112
S5202,Timothy Roza,39,75,24,138
S5203,Leo Hammons,54,82,66,202
S5204,Angelina Jackson,1,24,12,37
S5205,Bob Martinez,73,30,100,203
S5206,Amanda Jones,67,27,58,152
S5207,Amber Eilers,49,89,24,162
S5208,Latanya Rivera,35,35,43,113
S5209,Shawn Jacobsen,36,93,97,226
S5210,Kristen Mcgriff,43,82,45,170
S5211,Karin Hines,81,28,46,155
S5212,Nora Christensen,38,73,68,179
S5213,Robert Suggs,11,92,47,150
S5214,Irene Wagner,29,51,17,97
S5215,Rosie Bushovisky,63,65,87,215
S5216,Elizabeth Velazquez,59,43,88,190
S5217,Michael Davis,70,22,38,130
S5218,Mildred Mccray,16,0,24,40
S5219,John Hansen,11,12,64,87
S5220,Bertha Burgess,4,54,52,110
S5221,Jennifer Ulrich,72,67,7,146
S5222,Hazel Nelson,22,18,50,90
S5223,Meagan Hayes,27,48,60,135
S5224,Arturo Lewis,44,18,88,150
S5225,Josephine Henderson,8,24,78,110
S5226,Sue German,58,85,70,213
S5227,Vivian Summa,30,94,44,168
S5228,June Jones,100,67,40,207
S5229,Barbara Lake,92,67,33,192
S5230,Carl Davis,27,68,19,114
S5231,Charles Dickman,51,52,75,178
S5232,Sharon Clark,82,59,73,214
S5233,Kevin Hilson,6,80,64,150
S5234,Hassie Dishman,64,100,22,186
S5235,William Roberts,77,37,15,129
S5236,Michael Barbe,21,8,74,103
S5237,Lynn Messer,1,31,17,49
S5238,Edmond Stradley,52,62,72,186
S5239,William Huling,26,20,87,133
S5240,Shawn Cox,47,82,89,218
S5241,Brian Hunt,30,75,40,145
S5242,Roger Evans,82,6,100,188
S5243,Omar Mccrossen,15,41,19,75
S5244,Coleen Swiney,53,75,46,174
S5245,Jeffery Hoyt,38,53,43,134
S5246,Lynn Vidal,1,80,86,167
S5247,Mary Underwood,52,45,64,161
S5248,Mary Gardner,16,33,53,102
S5249,Dolores Galloway,57,34,41,132
S5250,Carl Quillen,32,93,91,216
S5251,Michelle Powell,6,84,23,113
S5252,Martin Burch,36,71,60,167
S5253,Anthony Wallace,67,0,92,159
S5254,Ruby Summers,66,65,14,145
S5255,Randy Jackson,44,52,13,109
S5256,George Arce,23,83,50,156
S5257,Joel Stevenson,4,41,31,76
S5258,Sonia Chadbourne,96,5,51,152
S5259,Jaqueline Crosno,69,3,53,125
S5260,Alta Edwards,35,33,29,97
S5261,Tiffany Bradley,69,77,55,201
S5262,Jeane Blakney,12,94,57,163
S5263,David Fox,52,57,17,126
S5264,Ernest Denyes,86,9,8,103
S5265,Nicole Williams,50,28,30,108
S5266,Paul Andrews,11,82,9,102
S5267,Daniel Perdue,77,10,2,89
S5268,Brenda Bourgeois,96,64,93,253
S5269,Duane Casados,47,9,0,56
S5270,John Lovett,39,54,16,109
S5271,Deborah Gehring,75,1,100,176
S5272,Blanche Strong,89,63,43,195
S5273,Jill Gregory,64,92,99,255
S5274,Juanita Corbridge,53,90,29,172
S5275,Todd Peters,9,51,54,114
S5276,Michael Crispin,23,72,14,109
S5277,Kimberly Pemberton,14,38,80,132
S5278,Louis Lightfoot,89,37,90,216
S5279,Paul Kirby,26,33,49,108
S5280,Jeffrey Morris,44,65,61,170
S5281,Thomas Malave,36,76,91,203
S5282,Tiffani Peterson,71,95,98,264
S5283,Shirley Jones,38,66,63,167
S5284,John Young,1,58,25,84
S5285,Saul Day,11,62,50,123
S5286,Susan Brisco,21,32,80,133
S5287,Alisha Davidson,69,1,5,75
S5288,Dawna Munoz,51,75,32,158
S5289,Mary Peppard,18,67,19,104
S5290,Evelyn Clements,13,73,27,113
S5291,Todd Apolo,95,52,48,195
S5292,Judy Butler,66,46,33,145
S5293,Michael Macchione,67,49,72,188
S5294,Ellen Carasco,3,39,32,74
S5295,Colleen Stewart,41,70,29,140
S5296,Zachary Dennis,59,6,44,109
S5297,Ruby Owens,49,46,87,182
S5298,Christine Quick,48,31,59,138
S5299,Dale Walker,32,29,58,119
S5300,Louis Sloan,63,100,7,170
S5301,Theresa Beavers,54,58,76,188
S5302,Jennifer Ponce,24,47,58,129
S5303,Lilly Prater,30,99,49,178
S5304,Samatha Fern,0,40,9,49
S5305,Darlene Hoskins,3,22,93,118
S5306,Ward Lafollette,54,91,4,149
S5307,Jeffrey Tapia,68,100,27,195
S5308,Dennis Proffer,49,37,50,136
S5309,Julia Zana,72,55,40,167
S5310,James Hopkins,56,80,75,211
S5311,Dana Alvarez,43,18,94,155
S5312,Helen Burton,19,98,25,142
S5313,Louis Harlow,5,4,4,13
S5314,Ashley Shea,44,76,51,171
S5315,Ruth Klepchick,14,100,27,141
S5316,Sam Simon,78,93,85,256
S5317,Preston Dansie,95,9,28,132
S5318,Kelly Pritt,75,100,33,208
S5319,Debra Koonce,79,84,33,196
S5320,Richard Soto,62,37,74,173
S5321,Loretta Davis,39,40,12,91
S5322,Antonio Castaneda,61,72,53,186
S5323,Lawrence Brosius,23,16,56,95
S5324,Mark Young,31,24,87,142
S5325,Kathryn Simons,39,92,63,194
S5326,Beulah White,68,7,1,76
S5327,David Barlow,33,57,49,139
S5328,Johnna Berube,61,84,22,167
S5329,Jesse Sajovic,19,9,40,68
S5330,Arturo Seibert,31,31,44,106
S5331,Edwin Blackwell,18,27,62,107
S5332,Charlene Gough,64,9,33,106
S5333,Raymond Stoppkotte,32,11,30,73
S5334,Judith Evans,35,12,28,75
S5335,Robert Williams,66,28,64,158
S5336,Mohammed Myles,60,43,62,165
S5337,Dianna Baeza,39,48,95,182
S5338,Lydia Mcclellan,41,88,2,131
S5339,Amanda Greene,73,95,36,204
S5340,Robert Miller,45,40,97,182
S5341,Valerie Pineda,53,87,72,212
S5342,Carey Manning,25,16,45,86
S5343,Wallace Mohr,55,72,96,223
S5344,Karen Hayner,69,16,83,168
S5345,Michael Putnam,11,89,7,107
S5346,Veronica Cavender,59,29,82,170
S5347,Kimberly Curtis,78,14,14,106
S5348,Ina Jackson,84,8,75,167
S5349,Chad Sitton,25,92,44,161
S5350,Julie Oakley,73,10,92,175
S5351,Elizabeth Sweet,1,19,22,42
S5352,Russell Gochal,90,33,81,204
S5353,Ellen Vollmer,43,51,14,108
S5354,Hope Richter,5,29,37,71
S5355,Charles Barton,32,42,44,118
S5356,Christopher Beavers,49,85,88,222
S5357,Robert Dupree,53,77,67,197
S5358,Pauline Conley,84,11,55,150
S5359,Leon Hart,52,77,65,194
S5360,Larry Richards,32,48,17,97
S5361,Helen Molino,31,74,63,168
S5362,Janett Blay,39,88,58,185
S5363,Vincent Lewis,73,22,27,122
S5364,Nathan Anderson,99,82,9,190
S5365,Andrew Tribley,62,25,75,162
S5366,Shirley Chronis,84,96,41,221
S5367,Charlene Wellenstein,97,79,47,223
S5368,Maria Allen,14,87,70,171
S5369,Christopher Thomas,36,43,99,178
S5370,Vicki Rogers,10,83,9,102
S5371,Barbara Coplin,74,76,99,249
S5372,Nancy Doyle,10,48,93,151
S5373,Michael Griffin,75,35,86,196
S5374,Dennis Jones,91,41,6,138
S5375,Tina Davis,77,13,33,123
S5376,Louise Balson,68,28,79,175
S5377,Jared Pollard,7,34,99,140
S5378,Kelley Griglen,6,80,55,141
S5379,James Williams,97,25,35,157
S5380,Goldie Stephenson,91,75,84,250
S5381,David Zent,62,93,98,253
S5382,Brian Thompson,2,32,52,86
S5383,Raymond Ryan,45,8,14,67
S5384,Karen Leal,50,26,91,167
S5385,Mitchell Smith,24,67,89,180
S5386,Jim Smith,46,100,26,172
S5387,Helen Bowen,23,47,100,170
S5388,Mary Petersen,88,75,79,242
S5389,Irene James,84,8,48,140
S5390,Cynthia Costain,36,24,74,134
S5391,James Hales,33,88,26,147
S5392,Pamela Perryman,87,89,53,229
S5393,Steven Hampton,23,23,89,135
S5394,Jill Dunn,9,37,2,48
S5395,David Thomas,10,35,80,125
S5396,Heidi Richardson,11,58,2,71
S5397,Steven Mumford,20,44,98,162
S5398,Jay Loucks,92,10,94,196
S5399,Jacqueline Taylor,85,52,85,222
S5400,Lillie Christopherso,4,10,73,87
S5401,Julio Wallace,8,6,48,62
S5402,Stacey Kitchen,2,64,17,83
S5403,Bobby Levine,17,67,77,161
S5404,Anthony Quiroz,94,76,60,230
S5405,Judy Lingo,44,23,8,75
S5406,Terri Bullock,49,8,38,95
S5407,Virginia Palmer,25,2,21,48
S5408,Jeanie Hardwick,40,68,3,111
S5409,Enriqueta Heras,42,45,96,183
S5410,Edward Gandhi,42,84,36,162
S5411,Tonya Tomlin,43,62,93,198
S5412,Dorothy Luallen,33,65,26,124
S5413,Erika Green,94,79,62,235
S5414,Rosa Ortiz,94,19,9,122
S5415,Curtis Young,52,23,21,96
S5416,Rachelle Penya,94,52,23,169
S5417,Cecelia Tola,20,11,50,81
S5418,Jennifer Sanchez,42,43,1,86
S5419,Terri Proffitt,61,30,49,140
S5420,Anna Cannon,100,67,57,224
S5421,Lee Banks,54,73,75,202
S5422,Audrey Walters,51,53,50,154
S5423,Maurice Tieman,31,50,14,95
S5424,Richard Kozma,100,73,51,224
S5425,Robert Hannasch,11,89,17,117
S5426,Dorothy Irby,69,10,41,120
S5427,Melissa Desrosiers,16,43,93,152
S5428,Le Sharp,53,20,86,159
S5429,Laurel Torgerson,14,90,92,196
S5430,Kyong Donnerberg,36,12,2,50
S5431,Edward Musgrave,51,10,72,133
S5432,Annette Bryant,92,33,59,184
S5433,Michael Eisman,49,36,21,106
S5434,Kenneth Pearsall,71,44,99,214
S5435,Agustin Atkins,47,56,62,165
S5436,Andrea Young,28,55,74,157
S5437,Gerard Barrickman,15,91,2,108
S5438,Rose Caudill,31,42,11,84
S5439,Clara Cochrane,27,96,52,175
S5440,Anita Cole,43,72,60,175
S5441,Anita Hoose,74,67,95,236
S5442,Amy Judd,87,65,30,182
S5443,Mattie Lord,10,18,47,75
S5444,Beverly Mack,34,22,39,95
S5445,Bill Russell,83,50,19,152
S5446,Rodney Bryant,55,61,81,197
S5447,Marlene Miramontes,81,27,97,205
S5448,James Ashley,25,1,96,122
S5449,Frank Adkerson,51,4,52,107
S5450,Priscilla Weathersby,3,21,12,36
S5451,Corey Estrada,31,67,73,171
S5452,Alice Kintopp,84,72,96,252
S5453,James Humes,35,73,42,150
S5454,Raymond Blanchard,5,52,67,124
S5455,Arthur Williams,47,79,60,186
S5456,Calvin Boucher,99,67,79,245
S5457,Billie Allen,100,80,52,232
S5458,Lynn Surratt,57,97,11,165
S5459,Lisa Villa,67,35,3,105
S5460,Paul Goldberg,90,100,11,201
S5461,Emerson Corbitt,99,20,100,219
S5462,Lewis Riddick,14,5,98,117
S5463,Jason Anderson,74,14,14,102
S5464,Bettie Hunt,38,65,58,161
S5465,Brandie Thies,86,69,62,217
S5466,Bonnie Stern,15,28,92,135
S5467,Zachary Bear,87,81,70,238
S5468,Raymond Duran,50,14,5,69
S5469,Etta Alewine,4,47,70,121
S5470,Milton Miller,41,3,84,128
S5471,Tommy Good,74,32,27,133
S5472,Nadia Britton,61,72,13,146
S5473,Karen Mikasa,20,75,63,158
S5474,Jamie Anderson,19,75,24,118
S5475,James Taylor,14,47,15,76
S5476,Jennifer Saine,19,7,12,38
S5477,Geoffrey Gulledge,91,37,98,226
S5478,Alfredo Leppla,1,73,89,163
S5479,Denise Williamson,70,66,6,142
S5480,Philip Mulcahy,58,57,11,126
S5481,Jessica Hartmann,24,46,89,159
S5482,Luke Sacco,80,42,85,207
S5483,Cynthia Vang,76,63,64,203
S5484,Willie Figueroa,75,27,71,173
S5485,Robert Lester,71,36,93,200
S5486,Blanca Walker,81,0,45,126
S5487,Lawanda Gaines,66,45,18,129
S5488,Rochelle Santiago,24,99,14,137
S5489,Jennifer Tejera,3,93,21,117
S5490,Frederick Marchiori,5,56,64,125
S5491,Jason Johnson,100,20,74,194
S5492,Donald Mason,19,73,1,93
S5493,Dennis Jones,93,24,42,159
S5494,Joyce Gonzalez,92,24,84,200
S5495,Derrick Deruyter,70,85,47,202
S5496,Brent Emily,30,1,75,106
S5497,Justin Arnette,19,58,53,130
S5498,Timothy Zak,46,9,55,110
S5499,Linda Scott,20,94,73,187
S5500,Roxanna Dutra,4,93,34,131
S5501,Katheleen Mccoy,43,40,67,150
S5502,Chad Murphy,91,49,64,204
S5503,Carrie Manney,12,64,3,79
S5504,Shane Burke,7,53,81,141
S5505,Barbara Coleman,52,60,63,175
S5506,Scott Johnston,58,80,51,189
S5507,Edna Zarate,62,49,43,154
S5508,Steve Alexander,92,72,59,223
S5509,Maurice Mcneill,70,100,11,181
S5510,Susan Stark,6,5,79,90
S5511,Susana Le,29,47,72,148
S5512,Carol Stiles,29,7,86,122
S5513,William Davis,42,9,70,121
S5514,Ronald Dill,31,27,83,141
S5515,Anthony Shah,88,19,90,197
S5516,Gerardo Vandorp,56,26,31,113
S5517,Blanca Levinson,50,72,77,199
S5518,Donna Cunningham,30,52,40,122
S5519,Elizabeth Karins,54,39,77,170
S5520,Edith Scott,89,56,77,222
S5521,Kelly Mcintosh,57,85,25,167
S5522,Janet Renner,32,65,8,105
S5523,Tad Jordon,60,95,75,230
S5524,Wanda Vick,21,97,98,216
S5525,Jaime Bell,7,59,6,72
S5526,Jeanette Johnson,77,66,33,176
S5527,Walter Sexton,75,71,45,191
S5528,Frank Jones,93,62,80,235
S5529,Michael Roland,77,11,53,141
S5530,Whitney Gordan,54,9,42,105
S5531,Mark Merchant,10,6,37,53
S5532,Lucile Bateman,70,18,45,133
S5533,David Thomas,47,11,83,141
S5534,Jack Orloff,38,50,7,95
S5535,Shirley Barber,71,7,86,164
S5536,Edward Kim,39,12,24,75
S5537,Suzanne Kappeler,48,71,75,194
S5538,Josephine Leu,28,7,72,107
S5539,Paula Verley,90,70,97,257
S5540,Anna Wright,81,82,9,172
S5541,George Hinkle,95,13,15,123
S5542,Beverly Thomas,81,49,67,197
S5543,Doris Johnson,64,34,32,130
S5544,Lisa Burton,85,92,72,249
S5545,Donna Kopka,67,28,13,108
S5546,Arturo James,32,86,38,156
S5547,Jennifer Montano,87,49,45,181
S5548,Stephanie Swenson,93,78,3,174
S5549,James Smith,81,38,87,206
S5550,James Crow,84,51,54,189
S5551,Ella Murphy,39,30,62,131
S5552,Paris Bathke,73,61,18,152
S5553,Genevieve Fuentes,22,6,60,88
S5554,James Greenfield,53,61,18,132
S5555,Linda Denham,63,84,23,170
S5556,Michelle Waldron,24,76,88,188
S5557,Kelly Tesoriero,41,92,7,140
S5558,Norma Johnson,73,29,87,189
S5559,Jack Barajas,85,11,48,144
S5560,Jose Johnson,26,22,6,54
S5561,Monty Hayden,59,90,38,187
S5562,Lisa Baker,33,76,22,131
S5563,Barbara Sluka,72,46,40,158
S5564,Brandon Sowl,74,32,91,197
S5565,Michael Rosengren,85,25,46,156
S5566,Krista Yoo,8,20,96,124
S5567,Joseph Williams,1,46,39,86
S5568,Joseph Zastrow,48,78,52,178
S5569,Dorothy Richardson,85,77,75,237
S5570,Romeo Gonez,40,19,69,128
S5571,James Sands,100,34,69,203
S5572,Victoria Mims,50,58,38,146
S5573,Patsy Christian,24,78,19,121
S5574,Jennifer Byler,79,5,33,117
S5575,Joshua Laird,94,70,90,254
S5576,Colleen Duffy,58,14,48,120
S5577,Dorothy Strahan,9,86,23,118
S5578,Kayla Burton,13,87,19,119
S5579,Rose Morris,40,17,31,88
S5580,Allan Morgan,58,24,84,166
S5581,Jacqueline Bartlett,6,7,12,25
S5582,Dorothy Ebling,51,96,33,180
S5583,Shelby Benavides,89,84,16,189
S5584,Annie Webster,51,58,4,113
S5585,Dorothy Burwood,1,34,55,90
S5586,Larry Santiago,11,30,86,127
S5587,Sheila Nolan,40,9,62,111
S5588,Erin Abernathy,60,31,25,116
S5589,Bradford Wismer,83,18,18,119
S5590,Adam Coulson,37,8,34,79
S5591,Jenni Eller,89,50,26,165
S5592,Adam Bradshaw,96,78,38,212
S5593,Dorothy Livingston,93,52,55,200
S5594,Francisco Sandquist,33,17,87,137
S5595,Karen Conklin,70,27,56,153
S5596,Alma Ceballos,50,63,16,129
S5597,Catherine Jones,93,36,20,149
S5598,Tyler Bica,24,61,64,149
S5599,Natalie Burkett,71,1,37,109
S5600,Walter Jury,72,56,23,151
S5601,Cynthia Justice,59,59,99,217
S5602,Anne Hamblin,36,13,49,98
S5603,Maria Fry,49,86,2,137
S5604,Eugene Malone,44,41,4,89
S5605,Jeanna Mann,30,12,43,85
S5606,Leticia Evetts,89,40,8,137
S5607,Victor Vandre,4,0,0,4
S5608,Jerry Hockenberry,35,55,28,118
S5609,Thomas Christman,95,38,46,179
S5610,Derek Cummins,81,24,59,164
S5611,Charles Garrett,95,10,56,161
S5612,Angel Horne,89,37,95,221
S5613,Marian Pierce,52,52,30,134
S5614,Charlotte Salisbury,83,82,70,235
S5615,Lee Davis,53,66,9,128
S5616,Michael Gillespie,94,77,30,201
S5617,Laura Hernandez,83,79,32,194
S5618,Thomas Wilder,41,80,35,156
S5619,Joseph Lanz,88,10,38,136
S5620,Joann Hartson,73,6,66,145
S5621,Jerry Singleton,16,9,8,33
S5622,Kathleen Hutchins,37,82,100,219
S5623,Ricardo Daniels,99,65,8,172
S5624,Geneva Dube,11,83,48,142
S5625,James Gingras,51,50,79,180
S5626,Catherine Roberts,15,31,69,115
S5627,Vicki Jackson,32,37,90,159
S5628,Judy Dangelo,88,99,34,221
S5629,Dorothy Dixon,38,91,96,225
S5630,Frankie Farmer,50,56,43,149
S5631,Mildred Starzyk,83,59,34,176
S5632,Sandra Cooper,47,11,15,73
S5633,Bonita Brady,63,68,36,167
S5634,John Mayes,58,58,20,136
S5635,Samuel Terrell,54,2,32,88
S5636,Kathryn Brown,9,40,4,53
S5637,Isaac Louie,84,81,18,183
S5638,Jessica Cary,29,87,54,170
S5639,Rita Gibson,85,25,9,119
S5640,Patricia Brooks,12,38,90,140
S5641,Dorothy Hewitt,27,41,41,109
S5642,Johnathan Miller,26,23,93,142
S5643,Anna Walls,23,74,95,192
S5644,Margaret Hopper,70,22,56,148
S5645,Roger Meador,78,22,43,143
S5646,David Lewis,71,64,61,196
S5647,Connie Garfield,13,98,90,201
S5648,Jennifer Staton,72,81,66,219
S5649,Stacey Hall,81,31,56,168
S5650,Gerald Godfrey,74,8,96,178
S5651,Tyler Bala,21,62,26,109
S5652,James Boles,46,8,29,83
S5653,Christopher Matias,41,14,0,55
S5654,Mary Finney,16,51,45,112
S5655,Robert Phipps,47,52,54,153
S5656,Brenda Finch,83,9,92,184
S5657,David Ring,66,14,25,105
S5658,Mildred Driever,80,4,70,154
S5659,Leslie Sherwood,24,49,83,156
S5660,Francis Shepherd,28,96,8,132
S5661,Donovan Clark,74,88,54,216
S5662,Mary Carter,41,77,23,141
S5663,Joann Lyman,15,39,87,141
S5664,Matthew Millay,72,14,3,89
S5665,Jill Medina,58,96,94,248
S5666,Bryan Mitchell,71,35,89,195
S5667,Ena Rivera,39,36,7,82
S5668,Quincy Krueger,4,49,33,86
S5669,Chery Proctor,96,80,41,217
S5670,Robert Pringle,48,22,81,151
S5671,Louis Moralis,67,47,94,208
S5672,Alexander Leary,68,78,43,189
S5673,Charles Cureton,68,30,62,160
S5674,Abraham Lopez,59,80,49,188
S5675,Carmela Crier,57,85,94,236
S5676,Nellie Howard,52,99,26,177
S5677,Rose Gerken,53,17,35,105
S5678,Kerstin Berrios,92,99,50,241
S5679,Sheri Schultz,8,63,60,131
S5680,Laura Naquin,60,22,47,129
S5681,Michael Halford,78,71,64,213
S5682,Phillip Richardson,88,22,68,178
S5683,Lucille Donnelly,9,2,22,33
S5684,Melissa Wiggins,65,87,6,158
S5685,Gloria Massey,3,43,80,126
S5686,Debra Feinstein,42,25,20,87
S5687,Tommie Triana,25,37,97,159
S5688,Pauline Salinas,72,32,54,158
S5689,Janet Champlin,65,52,56,173
S5690,Dion Kelly,92,24,93,209
S5691,Bonita Hill,49,75,35,159
S5692,Cindy Brandenburg,75,4,57,136
S5693,Patrick Olszewski,54,29,76,159
S5694,Brain Romero,3,42,100,145
S5695,Robert Dingee,61,37,73,171
S5696,Ruby Handley,23,62,44,129
S5697,Amy Dixon,93,35,61,189
S5698,Alberta Ashley,0,30,86,116
S5699,James Kida,13,99,17,129
S5700,Gracie Amick,99,15,85,199
S5701,Eric Baker,88,14,68,170
S5702,Mary Montgomery,93,46,85,224
S5703,Moises Davis,85,52,0,137
S5704,Melinda Slaughter,32,20,6,58
S5705,Ana Avila,46,45,46,137
S5706,Brian Addison,46,54,28,128
S5707,James Phillips,83,58,75,216
S5708,Darryl Carrington,78,92,3,173
S5709,Elizabeth Kleinpeter,56,44,73,173
S5710,Marisela Waters,8,79,36,123
S5711,Richard Guerra,59,31,9,99
S5712,Bryan Brown,82,33,85,200
S5713,Timothy Bennett,90,95,1,186
S5714,Luis Lewter,21,50,66,137
S5715,Max Moorehead,22,6,15,43
S5716,John Groys,24,36,47,107
S5717,Myra Malcolm,31,42,49,122
S5718,Man Bennett,35,3,67,105
S5719,Melissa Mcreynolds,26,26,20,72
S5720,Becky Hobbs,24,22,85,131
S5721,Mary Pike,49,42,3,94
S5722,Mamie Berry,41,37,55,133
S5723,Grace Wortham,12,76,27,115
S5724,Mary Joshua,10,63,72,145
S5725,Jennifer Muros,8,84,46,138
S5726,Gregory Grubbs,82,6,59,147
S5727,Henry Ventura,70,38,99,207
S5728,Jenna Bedard,76,93,58,227
S5729,Kenneth Raber,59,15,37,111
S5730,Mara Wilson,9,5,87,101
S5731,Ellen Smallwood,68,33,75,176
S5732,Erin Degroot,82,67,20,169
S5733,Alice Pigeon,51,7,99,157
S5734,Sean Mcclure,38,61,90,189
S5735,Elizabeth Flath,63,3,14,80
S5736,James Wood,3,81,41,125
S5737,Neil Matthews,21,37,9,67
S5738,Ronald Pompey,81,18,97,196
S5739,Shannon Jones,39,79,78,196
S5740,Ivory Balzer,52,8,28,88
S5741,Helen Villasenor,59,92,81,232
S5742,James Mccright,26,7,22,55
S5743,Marilyn Oregel,21,98,9,128
S5744,Stacey Martin,38,4,93,135
S5745,Minh Delao,36,11,12,59
S5746,Dolly Sanders,22,31,43,96
S5747,William Ferrell,99,99,77,275
S5748,Jimmy Dubreuil,11,83,16,110
S5749,Lee Cordeiro,85,37,1,123
S5750,Debbie Trammell,28,98,96,222
S5751,Richard Schmidt,15,96,35,146
S5752,Jaime Mcclure,49,26,6,81
S5753,Gay Nightingale,41,75,13,129
S5754,Leslie Archie,1,20,24,45
S5755,Lucille Sharpe,28,68,31,127
S5756,Kevin Gragg,63,0,69,132
S5757,Eva Bishop,23,65,8,96
S5758,Sue Feldman,53,84,76,213
S5759,Robyn Sanchez,29,84,89,202
S5760,Cynthia Sydnor,81,43,84,208
S5761,Charles Tunnell,87,64,10,161
S5762,Anita Adams,2,34,36,72
S5763,Pauline Donson,23,14,32,69
S5764,Abe Patton,6,66,19,91
S5765,Elva Morales,61,29,95,185
S5766,Sandra Brown,45,28,80,153
S5767,Jan Briggs,23,9,68,100
S5768,Michael Reed,78,53,47,178
S5769,Joseph Fitzpatrick,49,62,31,142
S5770,Jean Ferris,39,22,94,155
S5771,Shawn Allen,14,26,11,51
S5772,James Laboy,19,26,26,71
S5773,Geraldine Fields,20,52,93,165
S5774,Dennis Maloney,44,44,90,178
S5775,Latanya Brousseau,67,87,78,232
S5776,Leo Bridenbaker,34,38,4,76
S5777,Clay Prins,9,19,62,90
S5778,Barbara Thompson,74,87,84,245
S5779,Joseph Lund,6,61,52,119
S5780,Mattie Marcos,29,4,49,82
S5781,Cheryl Sweet,43,73,23,139
S5782,Susan Curb,99,97,92,288
S5783,Charles Davis,45,65,48,158
S5784,Linda Richardson,40,87,75,202
S5785,Matthew King,54,4,68,126
S5786,Shawn Norton,11,59,89,159
S5787,Marla Dobies,67,58,1,126
S5788,Casey Gilstrap,69,2,90,161
S5789,Monica Caldwell,38,66,56,160
S5790,Anna Dagostino,81,32,35,148
S5791,Jessica Eaton,65,39,76,180
S5792,Christine Keller,80,95,29,204
S5793,Kelly Mason,31,93,36,160
S5794,Nora Haro,53,25,46,124
S5795,Robert Nixon,81,92,9,182
S5796,Louise Calligan,91,9,49,149
S5797,Terry Crump,21,14,60,95
S5798,Cheryl Johnson,16,15,70,101
S5799,Gerald Baker,23,53,14,90
S5800,Irene Wimer,17,47,30,94
S5801,Susan Stucker,44,21,10,75
S5802,Bettie Mull,8,29,75,112
S5803,Betty Stickland,56,26,54,136
S5804,James Nadeau,90,53,59,202
S5805,Connie Miller,5,10,92,107
S5806,Melissa Queen,21,6,17,44
S5807,Tina Filippini,19,11,0,30
S5808,William Broussard,90,47,96,233
S5809,Jewel Edge,70,66,48,184
S5810,William Parker,47,50,18,115
S5811,Sandra Webb,85,99,94,278
S5812,Jasmine Johnson,88,85,99,272
S5813,Cheryl Greer,66,9,77,152
S5814,Billy Dotson,70,69,56,195
S5815,Ora Turner,71,100,16,187
S5816,Adell Obrian,4,97,96,197
S5817,Richard Voorhies,54,53,90,197
S5818,Bertha Parker,48,77,13,138
S5819,Eric Claassen,74,57,100,231
S5820,Earnest Klinger,23,91,56,170
S5821,Jacqueline Simpson,74,28,9,111
S5822,John Brooks,1,57,37,95
S5823,Christopher Dahl,11,78,47,136
S5824,Michael Montgomery,56,56,32,144
S5825,Clay Guice,58,87,90,235
S5826,Marvin Souza,5,87,38,130
S5827,Brenda Glass,80,79,100,259
S5828,Joyce Tullar,44,44,19,107
S5829,Brian Keiper,47,11,84,142
S5830,Jimmy Perry,52,24,96,172
S5831,Lois Quince,88,38,2,128
S5832,Lana Villa,87,94,56,237
S5833,Renee James,27,12,98,137
S5834,Edgar Swain,54,57,7,118
S5835,Loren Wilusz,33,10,48,91
S5836,Josephine Robb,31,79,42,152
S5837,Nicholas Hines,42,95,27,164
S5838,Matthew Chilton,84,72,90,246
S5839,Matt Brown,51,49,10,110
S5840,Burl Sorrells,97,2,41,140
S5841,Shawn Bryd,4,73,9,86
S5842,Lee Cathey,13,85,56,154
S5843,Grace Weaver,77,7,76,160
S5844,Sam Davis,46,5,40,91
S5845,Christina Lyons,12,39,20,71
S5846,Irene Broberg,10,25,49,84
S5847,Joseph Byrd,93,77,48,218
S5848,Francisco Martin,59,56,16,131
S5849,Carlos Ross,26,35,57,118
S5850,Kirsten Leininger,60,49,65,174
S5851,Ben Blazek,86,71,96,253
S5852,Bradley Addington,25,39,44,108
S5853,Harley Rhea,75,4,84,163
S5854,Juan Osullivan,11,13,8,32
S5855,Tamara Thornton,76,23,53,152
S5856,Catherine Hoffman,73,94,18,185
S5857,Robert Mendoza,38,62,90,190
S5858,Sylvia Ewing,0,33,52,85
S5859,Richard Ford,48,82,24,154
S5860,Audrey Vaughan,97,90,23,210
S5861,Dennis Murillo,100,94,25,219
S5862,Paul Vargas,20,66,20,106
S5863,Elizabeth Hammon,40,67,90,197
S5864,Angela Stephens,64,81,22,167
S5865,Brian Hedrick,89,100,27,216
S5866,Diane Xayasith,89,27,6,122
S5867,Arthur Grimes,25,26,99,150
S5868,Walter Smith,75,80,90,245
S5869,Martha Renfro,45,7,76,128
S5870,Alice Cheung,78,98,52,228
S5871,Aaron Lundsten,55,91,68,214
S5872,Virginia Harris,67,13,14,94
S5873,Nancy Richmond,86,98,12,196
S5874,Angela Woods,1,86,50,137
S5875,Gavin Alford,26,21,100,147
S5876,Clarence Hunter,3,29,10,42
S5877,Agnes Gonzalez,70,61,15,146
S5878,Kimberly Rubinson,87,74,6,167
S5879,Fidel Bucher,76,65,77,218
S5880,Gerald Brangers,4,68,39,111
S5881,John Davis,52,57,81,190
S5882,Maria Held,22,26,47,95
S5883,Nathan Koontz,27,71,9,107
S5884,Judith Hawkins,82,90,22,194
S5885,Maria Stanley,21,42,32,95
S5886,Shannon Cates,43,46,32,121
S5887,Anne Higgins,34,98,6,138
S5888,Bethany Tubbs,16,50,97,163
S5889,Junior Gonzales,46,9,55,110
S5890,Lawrence Legra,40,21,6,67
S5891,Anna Fink,21,9,59,89
S5892,Lauryn Jacquez,87,47,76,210
S5893,Gary Squines,5,92,12,109
S5894,Kathy Jones,30,58,22,110
S5895,Wendy Shively,83,79,94,256
S5896,Richard Wright,93,36,95,224
S5897,Dwayne Bowens,9,87,63,159
S5898,Albert Smith,9,53,37,99
S5899,Rosanne Hennemann,49,80,38,167
S5900,Pamela Gilmore,64,97,2,163
S5901,Bernice Nemith,16,88,89,193
S5902,Jerry Chee,72,59,100,231
S5903,Kelly Ackerman,47,19,96,162
S5904,William Kolter,32,65,86,183
S5905,Cynthia Willmon,15,50,69,134
S5906,Elisha Bradley,33,55,89,177
S5907,Susan Bergeron,2,69,20,91
S5908,Linda Lott,87,3,23,113
S5909,James Perry,95,27,59,181
S5910,Linda Mason,61,66,6,133
S5911,Pablo Russell,84,2,86,172
S5912,Patsy Settles,46,34,58,138
S5913,Ray Thomas,59,31,71,161
S5914,Gregory Bidwell,63,74,22,159
S5915,Frank Brett,83,82,24,189
S5916,Josephine Minichiello,82,21,96,199
S5917,Linda Verrett,49,57,85,191
S5918,Frank Jepson,40,40,74,154
S5919,Andy Yanez,8,80,14,102
S5920,Anthony Miller,33,47,48,128
S5921,Tony Baker,34,23,37,94
S5922,William Besecker,73,23,8,104
S5923,Edgar White,11,54,8,73
S5924,Irene Jackson,5,73,24,102
S5925,Lauren Jones,32,58,72,162
S5926,Thelma Umphrey,97,98,54,249
S5927,Nichole Mitkowski,22,9,51,82
S5928,James Crumley,82,69,12,163
S5929,Carol Smith,89,100,93,282
S5930,Victor Talmage,88,60,34,182
S5931,Sarah Anderson,87,40,73,200
S5932,Ernest Hall,93,64,79,236
S5933,Linda Nelson,58,60,43,161
S5934,Lydia Painter,46,80,83,209
S5935,Jeffrey Fogg,60,53,92,205
S5936,Candace Bell,59,3,27,89
S5937,David Peterman,55,52,10,117
S5938,Audrey Royston,95,24,55,174
S5939,Francine Norsaganay,73,47,22,142
S5940,Ronald Seigler,28,9,89,126
S5941,Brian Ransom,89,62,66,217
S5942,Amber Robyn,20,76,76,172
S5943,Kenneth Sweet,54,11,14,79
S5944,Morgan Perez,47,58,61,166
S5945,Jerry Lopez,99,64,50,213
S5946,Amy Strange,6,48,4,58
S5947,Angela Perez,16,93,22,131
S5948,Valerie Delarosa,82,93,95,270
S5949,Ramon Alberding,6,52,49,107
S5950,Valerie William,88,4,58,150
S5951,Melvin Cote,62,73,56,191
S5952,Carolyn Mcdonald,58,51,3,112
S5953,Mary Andersen,15,63,38,116
S5954,Christie Campbell,71,41,20,132
S5955,Eric Rader,39,87,27,153
S5956,David Fitzgerald,8,39,76,123
S5957,Dalila Madison,33,14,55,102
S5958,Jennifer Southerland,98,71,33,202
S5959,Tasha Castaneda,66,41,7,114
S5960,Julie Stam,4,9,3,16
S5961,Lena Rudd,99,92,36,227
S5962,Beth Matheny,98,97,41,236
S5963,Rebecca Havenhill,50,4,78,132
S5964,Margaret Dawson,95,36,66,197
S5965,James Crowther,73,49,66,188
S5966,Mary Paul,52,38,20,110
S5967,Mei Bowman,77,54,90,221
S5968,Douglas Shambo,71,39,47,157
S5969,Jose Moore,64,22,57,143
S5970,Joseph Labossiere,66,15,10,91
S5971,Margaret Daniel,26,0,61,87
S5972,Michael Cusano,37,48,45,130
S5973,Marguerite Arredondo,7,91,9,107
S5974,Dennis Pepper,58,7,30,95
S5975,Ruby Bowman,45,96,14,155
S5976,Richard Roach,68,17,46,131
S5977,Zachary Merrill,100,42,57,199
S5978,Steven Cain,99,2,73,174
S5979,Caitlin Tooley,43,28,52,123
S5980,Robert Stewart,40,89,43,172
S5981,Jessica Murphy,34,84,85,203
S5982,Richard Montgomery,3,46,46,95
S5983,Renee Bauer,25,66,47,138
S5984,Amanda Crabtree,50,27,56,133
S5985,Pam Cazares,77,57,64,198
S5986,Scot Mullins,57,25,70,152
S5987,Lois Kramer,18,60,80,158
S5988,Daniel Chism,49,37,50,136
S5989,Beulah Summerville,65,50,19,134
S5990,Letha Wolters,27,81,27,135
S5991,Marilyn Franz,2,27,50,79
S5992,Zackary Stringfellow,75,48,21,144
S5993,Joseph Porter,11,79,88,178
S5994,John Erickson,98,79,49,226
S5995,Tia Brown,9,37,62,108
S5996,Daniel Nguyen,58,67,95,220
S5997,Donald Siu,62,84,98,244
S5998,Linda Sorge,65,0,40,105
S5999,Malik Nesslein,50,43,4,97
S6000,Theresa Berman,61,60,89,210
S6001,James Schooler,1,0,20,21
S6002,Mary Griego,46,16,12,74
S6003,Eva Kimball,62,58,0,120
S6004,David Silva,70,70,8,148
S6005,Lizzie Briggs,39,33,41,113
S6006,Lisa Stewart,8,75,74,157
S6007,Florence Petitjean,31,75,48,154
S6008,Nellie White,43,67,13,123
S6009,Clinton Pitpitan,80,27,82,189
S6010,Rosemary Ward,79,64,60,203
S6011,Clara Pioske,2,51,96,149
S6012,Julietta James,97,28,16,141
S6013,Carolyn Kim,84,65,81,230
S6014,Marisa Mccaslin,45,14,60,119
S6015,Theodora Whitman,78,23,38,139
S6016,Tanya Cvetkovic,8,78,16,102
S6017,Ivory Salzmann,0,67,57,124
S6018,Lana Maggio,27,86,64,177
S6019,Homer Rondon,26,62,98,186
S6020,Steven Lee,46,55,44,145
S6021,Bradley Turney,46,10,77,133
S6022,Yolanda Marin,46,52,37,135
S6023,Alex Cuppernell,52,9,22,83
S6024,Kathleen Norman,97,93,90,280
S6025,Nannie Resner,40,45,41,126
S6026,Jacob Dicus,89,93,86,268
S6027,Jeffrey Hyatt,49,47,67,163
S6028,Darrin Root,16,88,13,117
S6029,Preston Stohlton,51,39,60,150
S6030,Joseph Pickron,18,53,91,162
S6031,Michael Gonzales,64,50,66,180
S6032,Rebecca Jenkins,55,7,61,123
S6033,Ethel Sikorski,62,33,72,167
S6034,William Beckham,63,39,34,136
S6035,Donald Sharley,24,25,37,86
S6036,Kenneth Baeza,8,54,21,83
S6037,Wesley Soto,18,22,19,59
S6038,Peggy Phillips,97,36,84,217
S6039,Laura Watkins,74,24,16,114
S6040,David Clark,84,70,77,231
S6041,Cyril Davis,58,11,77,146
S6042,Brandy Kellem,87,87,87,261
S6043,Louise Shafer,28,44,19,91
S6044,Pamala Malone,7,64,72,143
S6045,Carl Mclean,94,24,30,148
S6046,Robyn Beasley,65,81,42,188
S6047,Julie Easton,57,64,65,186
S6048,Charles Burruss,63,17,89,169
S6049,Marie Parnell,52,99,100,251
S6050,Steven Regan,50,46,72,168
S6051,Stacy Cockrell,66,43,61,170
S6052,Deborah Howard,61,13,14,88
S6053,Ophelia Rodriguez,89,100,29,218
S6054,Kathleen Cintron,20,83,25,128
S6055,Sam Reid,91,50,96,237
S6056,Zenaida Payne,29,72,57,158
S6057,Alma Oday,1,84,67,152
S6058,Nancy Lander,51,42,27,120
S6059,Brandon Beabout,22,42,25,89
S6060,Carolyn Hutchens,44,95,13,152
S6061,Denise Chessman,22,19,69,110
S6062,Gerald Johnson,56,45,39,140
S6063,Daniel Cranford,55,87,31,173
S6064,Wilfredo Stone,68,64,12,144
S6065,Catherine Hern,95,81,62,238
S6066,Joseph Lester,52,37,18,107
S6067,Raymond Wilkison,9,84,6,99
S6068,Rickey Czapla,63,1,59,123
S6069,Jason Fontenot,90,10,90,190
S6070,Jenelle Barton,83,48,85,216
S6071,Lorraine Price,91,78,74,243
S6072,Fred Holsey,10,80,98,188
S6073,Evelyn Weida,98,27,41,166
S6074,Rachel Creighton,65,92,16,173
S6075,Marshall Hankins,75,80,43,198
S6076,Brandi Walker,49,88,17,154
S6077,Andrea Lara,90,5,37,132
S6078,Hazel Darby,12,51,25,88
S6079,Kimberly Evans,9,56,85,150
S6080,Alvin Watkins,69,62,14,145
S6081,Josephine Gray,6,24,49,79
S6082,Brian Velazquez,60,1,11,72
S6083,Karen Bell,31,68,50,149
S6084,John Lopez,42,65,58,165
S6085,Shirley Ryder,96,70,69,235
S6086,Dena Baim,56,56,54,166
S6087,Nicole Bunch,85,78,51,214
S6088,Jerry Smith,47,83,21,151
S6089,Joseph Mcdonald,12,43,30,85
S6090,Robert Alfonso,7,39,1,47
S6091,Jose Wright,96,62,93,251
S6092,Kelly Strickler,51,98,42,191
S6093,Tyrone Najera,85,17,95,197
S6094,Everette Jones,75,89,17,181
S6095,Michael Clare,26,58,75,159
S6096,Jenna Keely,56,34,39,129
S6097,John Tijerina,91,62,88,241
S6098,Kenneth Sittloh,77,84,23,184
S6099,Clara Dwyer,68,34,70,172
S6100,Charles Griffith,46,65,38,149
S6101,Linda Mack,86,18,54,158
S6102,Kathy Greene,21,17,63,101
S6103,Rosetta Browning,89,88,92,269
S6104,Joseph Zellars,65,11,51,127
S6105,Bettie Calicott,8,11,64,83
S6106,Kellie Delay,33,70,38,141
S6107,Danae Merritt,63,47,71,181
S6108,Valerie Thacker,41,80,87,208
S6109,Rachelle Mallia,92,95,52,239
S6110,Jerry Mott,15,69,76,160
S6111,Marjorie Blocker,40,29,25,94
S6112,Matthew Mcmahon,39,69,53,161
S6113,Gladys Pope,17,68,24,109
S6114,Ruthe Burns,43,20,49,112
S6115,Eric Prey,52,89,62,203
S6116,Joseph Williams,6,57,35,98
S6117,James Johnson,14,24,15,53
S6118,Kurt Hardiman,47,52,7,106
S6119,Mary Pimental,74,15,76,165
S6120,Johanne Hurst,86,5,61,152
S6121,Lee Darden,94,25,20,139
S6122,Randall Bigler,3,19,5,27
S6123,Mary Brown,43,18,100,161
S6124,Patricia Dent,40,59,67,166
S6125,Gary Gonzalez,39,25,83,147
S6126,Charles Teague,98,54,43,195
S6127,Brandi Keeney,43,38,96,177
S6128,Bruce Garcia,26,49,3,78
S6129,William Miles,91,63,66,220
S6130,Jonathon Zimmerman,97,84,79,260
S6131,Bertha Morales,7,91,55,153
S6132,Denise Schumann,22,0,8,30
S6133,Calvin Guffey,73,35,12,120
S6134,Karin Baker,6,21,40,67
S6135,Agnes Lynch,55,6,0,61
S6136,Matthew Bailey,33,44,25,102
S6137,Tashia Simpson,35,44,74,153
S6138,Antoinette Bookman,30,65,18,113
S6139,Myrtle Hemphill,13,41,52,106
S6140,Garry Anderson,38,26,85,149
S6141,Grace Boone,96,26,49,171
S6142,Paris Ford,6,36,62,104
S6143,Louise Cook,63,78,68,209
S6144,Kevin Wittwer,48,10,99,157
S6145,Ernestine Wagner,88,5,75,168
S6146,Alex Rodriguez,68,10,36,114
S6147,Richard Rauth,14,98,48,160
S6148,Rachel Owens,49,7,14,70
S6149,Kimberley Keiser,98,59,0,157
S6150,Janet Harrell,82,74,99,255
S6151,Lisa Koeller,58,37,65,160
S6152,Nicole Craiger,76,73,37,186
S6153,Walter Wiseman,41,1,44,86
S6154,Kenneth Robles,36,80,9,125
S6155,Beatrice Crenshaw,61,64,43,168
S6156,Heather Lara,4,60,18,82
S6157,Barbara Knie,13,24,32,69
S6158,Karen Antoniou,28,70,99,197
S6159,Joshua Lykins,47,6,53,106
S6160,James Santacruz,10,38,70,118
S6161,David Gallagher,92,44,43,179
S6162,Robert Davis,69,82,42,193
S6163,Alice Alexis,61,61,38,160
S6164,Kermit Roland,26,34,9,69
S6165,Laura Johnson,49,32,8,89
S6166,Christopher Lilly,17,46,92,155
S6167,Sergio Criswell,68,94,1,163
S6168,Russell Rost,30,19,68,117
S6169,Marlene Johnson,14,2,47,63
S6170,Barbara Metevier,59,26,65,150
S6171,Sharon Logue,58,20,28,106
S6172,Kathleen Jones,32,61,74,167
S6173,Samantha Enriquez,27,8,67,102
S6174,David Galvan,54,49,16,119
S6175,Christopher Carlton,25,69,27,121
S6176,Estelle Radcliffe,86,40,58,184
S6177,Marian Grajeda,72,39,24,135
S6178,Marsha Sampson,46,58,88,192
S6179,Edwin Bivins,56,69,45,170
S6180,Jennifer Bakerville,35,3,83,121
S6181,April Mumford,23,35,88,146
S6182,Connie Fisher,93,54,34,181
S6183,Marjorie Delacruz,94,21,53,168
S6184,Thomas Long,62,17,77,156
S6185,Guadalupe Pilcher,9,63,58,130
S6186,Harry Lawrence,0,20,76,96
S6187,Dion Maas,72,61,78,211
S6188,Paul Cunningham,38,95,22,155
S6189,Howard Schlick,4,53,93,150
S6190,Rebecca Gussler,43,19,72,134
S6191,Carrie Luallen,40,22,49,111
S6192,Jennifer Burgher,90,54,13,157
S6193,Sadie Kidd,57,54,58,169
S6194,Gary Perez,9,56,22,87
S6195,Mark Morris,83,46,27,156
S6196,Mike Skiles,41,23,34,98
S6197,Ashley Spence,13,58,7,78
S6198,Phillip Goodwin,59,62,57,178
S6199,William Williams,96,90,50,236
S6200,Donald Martin,97,53,11,161
S6201,Roger Shyne,9,98,27,134
S6202,Kathy Barron,0,14,99,113
S6203,Mary Dawson,93,87,70,250
S6204,Catherine Kemp,18,26,42,86
S6205,Hazel Dawes,21,88,79,188
S6206,Donald Canelo,14,0,67,81
S6207,Henrietta Hofheimer,90,48,60,198
S6208,Adam Cordell,10,59,46,115
S6209,Matthew Mercer,60,89,0,149
S6210,Donald Maynard,8,13,35,56
S6211,Lillian Stacy,85,78,55,218
S6212,Georgia Whalen,23,47,13,83
S6213,Doris Burrows,94,71,36,201
S6214,Jennifer Smith,47,12,15,74
S6215,Craig Dugas,19,1,47,67
S6216,Wayne Thrash,66,29,14,109
S6217,Dorothy Mathew,88,36,16,140
S6218,Sylvia Milton,86,1,3,90
S6219,Jordan Gomes,67,34,0,101
S6220,Lynn Martinez,87,48,8,143
S6221,Jean Axtell,48,41,13,102
S6222,Joseph Womble,81,89,0,170
S6223,Tracy Chan,71,30,81,182
S6224,Marjorie Cooper,42,22,39,103
S6225,Nicolette Kin,8,80,96,184
S6226,Britni Bowen,41,82,63,186
S6227,Richard Logan,65,42,21,128
S6228,Ethel Coar,0,32,100,132
S6229,Ramona Muniz,44,88,40,172
S6230,Floyd Rogers,22,15,73,110
S6231,Cary Eftekhari,78,43,100,221
S6232,Melvin Kellett,61,54,11,126
S6233,Yvonne Johnson,42,8,8,58
S6234,Kathryn Nadeau,30,85,72,187
S6235,Ophelia Ivory,39,32,57,128
S6236,Russel Orlando,29,63,25,117
S6237,Cleta Fisher,9,73,55,137
S6238,Tiffany Dorn,95,73,55,223
S6239,Curtis Saballos,59,87,22,168
S6240,Misty Billington,23,60,95,178
S6241,Maxine Bergsma,90,58,75,223
S6242,Carolyn Crosby,6,10,12,28
S6243,Bryant Mohan,62,81,89,232
S6244,Crystal Reed,13,10,25,48
S6245,Robert Young,34,50,28,112
S6246,Retha Jones,89,96,53,238
S6247,Cathy Rosi,22,23,50,95
S6248,Betty Kilgallon,44,26,36,106
S6249,Rodney Sumrall,83,70,99,252
S6250,Kelly Mccown,94,57,76,227
S6251,Regina Aldrich,34,97,69,200
S6252,Joel Eastwood,16,58,35,109
S6253,Tammy Dicken,80,63,45,188
S6254,Sean Phillips,12,68,25,105
S6255,Florence Cleghorn,83,31,51,165
S6256,Ana Imler,68,63,19,150
S6257,Earl Clarke,77,45,33,155
S6258,Alex Mcdonald,98,52,5,155
S6259,Sarah Hubbard,60,0,76,136
S6260,Heidi Mestas,10,58,28,96
S6261,Carrie Ziglar,69,21,4,94
S6262,Eric Smith,64,65,0,129
S6263,Judy Robins,93,37,44,174
S6264,Philip Hogan,27,56,68,151
S6265,Steven Douglas,29,50,80,159
S6266,Phyllis Hibbs,61,72,100,233
S6267,Margaret Asbell,15,24,94,133
S6268,Richard Velazquez,43,91,83,217
S6269,Richard Harrison,81,5,36,122
S6270,William Evans,48,89,69,206
S6271,Donald James,10,53,71,134
S6272,Francisco Cardinale,38,97,64,199
S6273,Ruben Mullen,76,83,16,175
S6274,Wayne Smith,43,77,73,193
S6275,Don Noel,26,5,75,106
S6276,Annie Holstein,3,84,31,118
S6277,Armando Frazier,35,35,77,147
S6278,Annette Pegg,27,65,58,150
S6279,Charles Burns,83,52,100,235
S6280,Nathan Holben,83,71,90,244
S6281,Gloria Popp,2,71,26,99
S6282,Dianna Fishback,83,20,80,183
S6283,Irma Alfonso,9,100,48,157
S6284,Susan Mcqueen,5,100,58,163
S6285,Gerald Wyant,3,88,37,128
S6286,Linda Slocum,56,28,39,123
S6287,Naoma Child,46,8,58,112
S6288,Ricky Weyrick,65,47,18,130
S6289,Brian Kaplan,74,69,41,184
S6290,Jessie Young,24,61,67,152
S6291,Richard Perdue,39,87,52,178
S6292,Andrew Thompson,93,31,51,175
S6293,Edward Kappel,49,45,82,176
S6294,Brenda Lamm,63,83,33,179
S6295,Greg Leonard,79,0,83,162
S6296,Michelle Fender,70,63,63,196
S6297,Kate Crist,92,54,82,228
S6298,Leonard Bryant,46,4,47,97
S6299,Christina Azure,8,28,27,63
S6300,Maggie Mitchell,92,12,3,107
S6301,Wesley Giordano,25,19,41,85
S6302,Dennis Francis,93,2,12,107
S6303,Irene Mcentee,97,19,22,138
S6304,John Aponte,95,5,14,114
S6305,Patricia Goessl,7,36,82,125
S6306,Alan Nelson,13,41,99,153
S6307,Lynn Potter,59,66,3,128
S6308,June Goff,15,43,31,89
S6309,Joyce Kugler,89,38,37,164
S6310,Ricky Klassen,56,77,84,217
S6311,Daniel Ewing,54,28,59,141
S6312,Julie Miller,37,38,36,111
S6313,Donald Childers,23,81,24,128
S6314,Jan Street,51,98,96,245
S6315,Mary Elliott,78,80,20,178
S6316,Carol Rodriguez,5,83,86,174
S6317,Mary Britton,27,49,13,89
S6318,James Matthews,16,38,11,65
S6319,James Owens,62,81,70,213
S6320,Albert Collier,58,94,14,166
S6321,James Malave,38,84,69,191
S6322,Edward Wright,71,82,43,196
S6323,May Joachim,68,82,51,201
S6324,Jerry Berhe,48,32,47,127
S6325,David Williams,76,31,29,136
S6326,Shannon Taylor,94,88,94,276
S6327,Mary White,99,10,30,139
S6328,Cecilia Drain,41,83,73,197
S6329,Mark Gargano,100,72,39,211
S6330,Jose Buckley,57,4,59,120
S6331,Hollis Bell,26,18,42,86
S6332,Dorthy Castillo,75,100,1,176
S6333,Robert Jarman,36,28,64,128
S6334,Clementine Tamborlane,66,46,25,137
S6335,Ella Atchity,1,3,83,87
S6336,Edward Davis,85,39,40,164
S6337,Nancy Bankston,85,85,81,251
S6338,Opal Johnson,6,94,35,135
S6339,Alison Mitchell,62,36,10,108
S6340,Krystal Bird,93,77,64,234
S6341,Linda Rens,53,64,40,157
S6342,Edward Burnett,96,53,79,228
S6343,Brenda Garcia,45,37,44,126
S6344,Gilbert Luna,20,35,15,70
S6345,Emmett Hamilton,90,65,30,185
S6346,Irene Rubio,98,18,59,175
S6347,August Stallings,8,50,80,138
S6348,James Guerrero,57,87,79,223
S6349,Thomas Clayton,88,92,81,261
S6350,Cheryl Pendleton,56,14,5,75
S6351,Thomas Jankowiak,52,5,69,126
S6352,Margie Taylor,45,15,66,126
S6353,Robert Marshall,10,30,6,46
S6354,Kristin Smith,66,84,0,150
S6355,Tracy Arrant,64,52,28,144
S6356,Mark Loughry,13,82,64,159
S6357,Sharon Velez,49,90,47,186
S6358,Lois Douglas,65,13,30,108
S6359,Shirley Held,24,86,85,195
S6360,Lona Roark,79,41,17,137
S6361,Evangelina Porter,99,23,100,222
S6362,Abel Ruiz,14,18,14,46
S6363,Nancy Pogue,95,65,44,204
S6364,Whitney Jackson,86,90,83,259
S6365,Ryan Hollis,93,60,16,169
S6366,Christopher Clark,67,20,80,167
S6367,Jamie Miller,68,81,92,241
S6368,Mark Whitehair,15,48,52,115
S6369,Alvin Brown,51,73,46,170
S6370,Carlos Spurlin,23,61,83,167
S6371,Emma James,52,97,81,230
S6372,Dustin Kazarian,57,62,17,136
S6373,Sandra Lane,66,52,85,203
S6374,Robert Niemi,94,88,82,264
S6375,Jose Chandler,57,24,23,104
S6376,Matthew Anderson,51,48,81,180
S6377,Karen English,4,26,53,83
S6378,Belinda Moss,65,22,63,150
S6379,Terrance Choe,3,85,37,125
S6380,Harry Johnson,17,63,95,175
S6381,Cristal Chadderton,41,0,52,93
S6382,Marvin Riley,22,8,55,85
S6383,Pam Bassett,26,20,90,136
S6384,Hershel Devoe,17,54,66,137
S6385,Millie Borrelli,90,97,50,237
S6386,Wendy Hurse,77,50,45,172
S6387,Christine Anderson,7,99,1,107
S6388,Laura Kirk,52,58,84,194
S6389,Teresa Leighton,79,71,8,158
S6390,Arlene Campbell,33,61,33,127
S6391,Todd Jones,40,38,89,167
S6392,Wm Flinn,84,39,28,151
S6393,Alan Zebell,80,74,46,200
S6394,William Ladner,22,17,20,59
S6395,Connie Cowart,37,6,12,55
S6396,Sarah Lasky,69,37,47,153
S6397,Jacob Phillips,56,31,35,122
S6398,Carolina Orange,44,56,73,173
S6399,Charlene Townsley,22,21,34,77
S6400,Robert Hrabovsky,70,66,55,191
S6401,Charlotte Lindsay,82,8,92,182
S6402,Tanya Mccall,97,81,57,235
S6403,Mae Burns,47,34,1,82
S6404,Sam Jones,76,73,86,235
S6405,Barbara Oneil,68,59,85,212
S6406,Suzanne Sangi,22,28,44,94
S6407,Charles Crane,39,75,84,198
S6408,Carolyn Lewis,62,92,29,183
S6409,Denise Houser,96,48,0,144
S6410,Paul Church,74,91,92,257
S6411,Steven Chessman,13,68,85,166
S6412,Richard Lara,3,66,71,140
S6413,Teresa Boyd,53,98,25,176
S6414,Susan Daugherty,40,87,7,134
S6415,Carlo King,94,17,79,190
S6416,Alfred Dayton,72,25,60,157
S6417,Timmy Young,15,4,50,69
S6418,Guadalupe Mclain,14,64,19,97
S6419,Kenneth Ceja,96,36,30,162
S6420,Dana Montgomery,67,61,8,136
S6421,Chris Millard,7,18,34,59
S6422,Joshua Strother,72,29,71,172
S6423,Hope Ogle,52,28,69,149
S6424,Alberto Wang,25,41,29,95
S6425,Francisco Groth,21,58,77,156
S6426,Daniel Banks,2,45,13,60
S6427,Melvin Strahan,58,59,83,200
S6428,Steven Garcia,70,26,80,176
S6429,Kyle Elliott,7,95,88,190
S6430,Helena Bowie,12,51,98,161
S6431,James Leyva,77,80,24,181
S6432,Archie Hare,60,97,26,183
S6433,Eugene Downey,21,39,69,129
S6434,Katelyn Field,14,94,92,200
S6435,John Harrison,63,81,57,201
S6436,Jennifer Sanders,9,0,30,39
S6437,Jayne Barber,60,81,47,188
S6438,Linda Luna,85,27,98,210
S6439,James Oshea,52,10,7,69
S6440,Penny Smith,11,67,28,106
S6441,Joan Mason,71,38,37,146
S6442,Willie Bush,96,24,33,153
S6443,Ralph Carter,92,83,83,258
S6444,Eugene Clemmer,32,36,79,147
S6445,Jasper Martin,94,31,25,150
S6446,Aaron Smith,65,39,63,167
S6447,Nancy Neal,59,90,59,208
S6448,Matthew Prince,83,79,31,193
S6449,Rufus Janosek,14,19,41,74
S6450,Lori Macias,67,94,25,186
S6451,Edward Mcgee,12,9,72,93
S6452,Jay Burnette,74,58,55,187
S6453,Agnes Mckee,5,43,7,55
S6454,Joseph Dickinson,97,20,93,210
S6455,Steven Kong,46,24,92,162
S6456,Maureen Bruckner,20,54,40,114
S6457,Eddie Phillips,93,57,34,184
S6458,Michelle Johnson,59,31,92,182
S6459,Mary Williams,50,77,90,217
S6460,Maria Rowles,94,57,38,189
S6461,Kristen Russell,100,5,18,123
S6462,Gladys Reid,21,32,91,144
S6463,Peter Robinson,32,49,71,152
S6464,Imogene Smith,59,42,14,115
S6465,Marisa Caylor,67,89,99,255
S6466,Don Campa,42,88,12,142
S6467,Elvira Reed,55,15,54,124
S6468,Samuel Johnson,75,26,32,133
S6469,Sally Barba,96,94,39,229
S6470,David Eaves,57,6,65,128
S6471,Michael Reynolds,8,2,54,64
S6472,Angela Richard,43,53,36,132
S6473,Joshua Laurence,47,73,39,159
S6474,Nicky Heister,4,84,41,129
S6475,Albert Bateman,62,37,93,192
S6476,David Shafer,52,91,75,218
S6477,Harvey Tessier,54,65,42,161
S6478,William Andersen,54,85,39,178
S6479,Joe Stout,31,78,99,208
S6480,Roger Holmes,25,60,84,169
S6481,Maureen Finch,51,62,14,127
S6482,Arthur Kitchen,9,76,94,179
S6483,Trevor Thompson,39,84,39,162
S6484,Lois Everson,42,42,46,130
S6485,Terry Zabel,91,28,8,127
S6486,Samuel Wheeler,77,48,96,221
S6487,David Perkins,63,46,87,196
S6488,Victor Brown,16,66,7,89
S6489,Thomas Forde,85,37,66,188
S6490,Joseph Judd,17,42,76,135
S6491,Leonard Paxman,5,72,4,81
S6492,Vanessa Dunseith,52,77,33,162
S6493,Mary Fridman,91,90,59,240
S6494,Dominique Cote,81,55,78,214
S6495,Albert Jamison,44,27,73,144
S6496,Jean Hawkins,51,75,19,145
S6497,Kathy Pope,72,77,15,164
S6498,Howard Garvin,5,79,31,115
S6499,Ian Dowdy,87,24,29,140
S6500,Robert Dillard,73,85,17,175
S6501,Ella Coffey,63,35,2,100
S6502,Nathan Dunleavy,77,70,20,167
S6503,Roger Sisneros,22,80,98,200
S6504,Johnnie Mcquirk,12,24,94,130
S6505,Stephen Blanks,76,2,82,160
S6506,Marlene Castillo,37,2,63,102
S6507,Lynn Ingram,3,34,99,136
S6508,Leonard Hill,60,15,75,150
S6509,Marlene Helder,88,16,11,115
S6510,Kevin Bradley,48,39,1,88
S6511,Dominick Simons,91,85,57,233
S6512,Franklin Turner,56,77,4,137
S6513,Virginia Tuttle,81,23,4,108
S6514,Jonathan Long,41,61,44,146
S6515,Ann Benavides,40,65,63,168
S6516,Jack Colon,69,84,61,214
S6517,Shirley Lopez,44,46,13,103
S6518,Juanita Brown,64,68,38,170
S6519,Adam Epstein,47,73,37,157
S6520,James Gunter,76,63,41,180
S6521,Joseph Heidrick,15,4,70,89
S6522,Miriam Ortiz,85,58,17,160
S6523,John Vanhuss,23,69,95,187
S6524,Stacey Randle,17,100,27,144
S6525,Elaine Slayton,91,71,43,205
S6526,Michael Berryhill,42,34,35,111
S6527,Masako Colindres,64,89,80,233
S6528,Cecily Kaufman,89,28,78,195
S6529,Frank Avery,83,49,2,134
S6530,Kathleen Collins,87,36,1,124
S6531,Autumn Norris,38,88,78,204
S6532,Carol Stafford,82,88,40,210
S6533,Norbert Dobson,86,39,60,185
S6534,Steve Harris,19,19,41,79
S6535,George Cornell,23,42,89,154
S6536,Sean Surrett,51,53,57,161
S6537,Robert Wise,92,74,37,203
S6538,Lisa Rossi,31,33,45,109
S6539,Michael Raso,64,51,84,199
S6540,Christopher Martinez,70,97,75,242
S6541,Beverly Matlock,40,5,60,105
S6542,Raymond Anderson,99,29,36,164
S6543,Patricia Gonzales,11,79,23,113
S6544,Scott Martinez,11,33,45,89
S6545,Paul Sammons,64,29,95,188
S6546,Gary Juan,83,91,85,259
S6547,Roger Washington,98,41,93,232
S6548,Gregory Mance,8,77,24,109
S6549,Hung Delgadillo,63,46,65,174
S6550,Joseph Morgan,70,46,29,145
S6551,Elizabeth Stephen,24,5,52,81
S6552,Kathleen Watley,13,98,10,121
S6553,Rebecca Jeffery,82,4,51,137
S6554,Howard Ali,36,45,68,149
S6555,Ella Campbell,66,50,67,183
S6556,Amy Choi,0,20,67,87
S6557,Terrance Buffey,90,61,56,207
S6558,Scott Bowen,80,36,80,196
S6559,Hubert New,13,27,7,47
S6560,Alexander Thoburn,9,37,38,84
S6561,Jodi Acker,81,46,78,205
S6562,Tara Coe,8,44,73,125
S6563,Megan May,50,81,19,150
S6564,William Tsang,18,55,90,163
S6565,Nenita Keith,8,95,5,108
S6566,Carmen Anthony,98,49,59,206
S6567,Jed Seamans,100,91,35,226
S6568,Louise Walker,66,21,13,100
S6569,James Brady,36,68,29,133
S6570,Barbara Hawkins,82,75,67,224
S6571,Walter Wiese,70,84,98,252
S6572,Sylvia Goud,89,84,34,207
S6573,Gary Kiely,67,68,71,206
S6574,Gordon Leider,66,39,95,200
S6575,Thomas Reynolds,84,82,68,234
S6576,Carole Murray,86,50,37,173
S6577,Aaron Littlewood,94,44,49,187
S6578,David Degasperis,9,18,16,43
S6579,Patty Faulk,85,52,64,201
S6580,Mary Bagg,31,46,6,83
S6581,Ana Rabideau,48,56,45,149
S6582,Miriam Davis,48,30,9,87
S6583,Joyce Hayes,23,3,72,98
S6584,Gladys Mckinney,75,73,62,210
S6585,Helen Kamai,6,89,84,179
S6586,William Harpster,82,44,31,157
S6587,Jessie Messier,91,23,11,125
S6588,Julie Guillette,83,9,97,189
S6589,Kenneth Carrillo,22,29,73,124
S6590,William Goldstein,11,70,49,130
S6591,Shawn Rivira,91,29,7,127
S6592,Alex Howard,24,79,97,200
S6593,John Gary,90,99,3,192
S6594,Maryjane Batte,79,17,41,137
S6595,Jenny Kelly,33,71,44,148
S6596,Fredric Hamilton,37,58,53,148
S6597,Effie Keys,67,84,77,228
S6598,Aaron Vargas,31,12,22,65
S6599,Larry Flores,46,58,14,118
S6600,Al Bibee,9,22,89,120
S6601,Marcia Carlson,78,99,62,239
S6602,Kenny Silva,48,20,94,162
S6603,David Thompson,25,7,64,96
S6604,Thomas Rhoades,2,3,6,11
S6605,Thomas Anderson,78,20,84,182
S6606,Vernon Burton,51,81,80,212
S6607,Donald Thompson,19,72,5,96
S6608,Adam Surgeon,10,80,81,171
S6609,Florence Rodriguez,60,21,79,160
S6610,Lula Espino,49,25,58,132
S6611,Derek Coe,15,60,15,90
S6612,Patrick Collins,45,13,15,73
S6613,Deedra Wade,17,54,65,136
S6614,Sandra Schuman,60,33,39,132
S6615,Anita Roundtree,68,43,19,130
S6616,Eric Stagg,38,82,87,207
S6617,Celeste Youngman,32,8,29,69
S6618,Betty Jefferson,67,78,88,233
S6619,Beulah Armbruster,90,27,85,202
S6620,Deann Edison,73,25,92,190
S6621,Richard Patrick,26,7,9,42
S6622,Ronald Hill,47,40,21,108
S6623,Daniel Rameau,69,53,66,188
S6624,Colleen Richardson,99,31,39,169
S6625,Anna Bixby,10,31,4,45
S6626,Alvin Herrera,44,83,8,135
S6627,Agnes Fullerton,20,71,1,92
S6628,Lucille Sanchez,48,17,13,78
S6629,James Goodson,1,10,30,41
S6630,Margie Doe,69,46,48,163
S6631,Rodney Brickman,84,6,90,180
S6632,Tonya Bramble,94,80,56,230
S6633,Nathan Ward,73,40,40,153
S6634,Paula Baeza,84,61,11,156
S6635,Albert Mcintosh,19,32,7,58
S6636,Sharyn Davis,96,70,81,247
S6637,Billy Hatfield,30,85,83,198
S6638,Diane Schneider,52,37,67,156
S6639,Mary Key,45,29,43,117
S6640,Felipe Tate,85,1,29,115
S6641,Darla Rodriguez,27,2,60,89
S6642,John Hobart,50,78,50,178
S6643,Rhonda Miller,8,57,64,129
S6644,Rose Simmons,97,56,84,237
S6645,Christine York,32,1,41,74
S6646,Mary Synder,74,91,81,246
S6647,William Akridge,3,34,6,43
S6648,Christopher Heard,65,98,43,206
S6649,Ralph Lowry,79,51,54,184
S6650,Peggy Burgess,82,64,13,159
S6651,Helen Smith,48,12,12,72
S6652,Melanie Talbot,86,92,58,236
S6653,Viva Jeffrey,33,63,6,102
S6654,Rafael Lauritsen,98,59,30,187
S6655,Alexis Thurlow,64,83,6,153
S6656,Joyce Peterson,92,59,28,179
S6657,Ryan Cull,85,98,65,248
S6658,Christopher Wood,56,8,23,87
S6659,William Macias,86,19,65,170
S6660,Joanne Jones,11,7,61,79
S6661,Philip Swank,19,96,17,132
S6662,Michael Griswell,31,68,29,128
S6663,Peter Hernandez,24,25,15,64
S6664,Dale Copeland,81,98,1,180
S6665,Jo Milton,26,67,21,114
S6666,James Armstrong,53,40,45,138
S6667,Sylvia Fox,13,77,1,91
S6668,Robert Eckhard,14,76,83,173
S6669,Steven Redding,79,11,73,163
S6670,Melba Amann,44,73,76,193
S6671,Casey Perry,23,67,35,125
S6672,Mary Kridler,96,98,48,242
S6673,Billy Bell,38,37,80,155
S6674,Mary Ashley,37,20,58,115
S6675,Timothy Amodeo,35,58,36,129
S6676,Ezequiel Aguas,92,3,22,117
S6677,Peggy Martinez,87,13,93,193
S6678,Dorothy Higa,92,42,67,201
S6679,Ernestine Burnett,53,89,50,192
S6680,Stephen Wittner,49,71,100,220
S6681,Ernest Cain,66,14,77,157
S6682,Hazel Matias,17,67,14,98
S6683,Sandra Foster,70,0,48,118
S6684,Cecilia Vachon,81,74,96,251
S6685,Victor Vanaria,76,83,30,189
S6686,Mark Oberg,49,91,53,193
S6687,Susan Serrano,48,87,69,204
S6688,Arthur Lee,89,6,62,157
S6689,Richard Klocke,96,61,3,160
S6690,David Legore,89,30,83,202
S6691,Sandee Poland,84,34,93,211
S6692,Amy Miller,5,43,86,134
S6693,Maryann Hollis,10,93,45,148
S6694,Nettie Baker,51,8,74,133
S6695,Justin Nealy,87,91,27,205
S6696,Laverne Vaughn,74,79,34,187
S6697,Luciano Smith,41,79,38,158
S6698,Erma Vondielingen,55,5,90,150
S6699,Allan Green,49,9,8,66
S6700,Kristie Brown,97,0,40,137
S6701,William Creekmore,41,88,74,203
S6702,Donna Carney,89,7,92,188
S6703,Helen Greer,84,99,43,226
S6704,Christina Creekmur,74,8,11,93
S6705,Jorge Schulman,43,26,51,120
S6706,Ronald Nichols,81,79,74,234
S6707,Ruth Ly,30,46,45,121
S6708,Ryan Menendez,75,60,14,149
S6709,Kathleen Fitzgerald,60,21,93,174
S6710,Todd Mccarroll,90,12,19,121
S6711,Deborah Schleicher,13,97,70,180
S6712,Laurie Monger,94,5,5,104
S6713,Edna Casas,53,13,10,76
S6714,Tim Mcbride,1,15,95,111
S6715,Tracy Cole,12,94,40,146
S6716,Bess Beck,53,11,3,67
S6717,Ramona Lucas,5,12,13,30
S6718,Nicole Young,20,33,99,152
S6719,Manuel Mitchell,55,98,40,193
S6720,Reginald Brainard,83,1,79,163
S6721,Carlos Jarvis,10,3,80,93
S6722,Lester Newman,74,67,56,197
S6723,Manuel Hottinger,69,82,23,174
S6724,Graciela Wells,85,84,10,179
S6725,Margaret Torres,27,25,48,100
S6726,Albert Richardson,73,39,37,149
S6727,Amanda Shores,44,88,4,136
S6728,Gary Maraldo,5,90,20,115
S6729,Joe Vasquez,51,34,39,124
S6730,Laurie Patterson,46,16,28,90
S6731,Marquerite Mulford,27,40,16,83
S6732,Clifford Hagge,97,3,13,113
S6733,Christa Luce,19,80,40,139
S6734,James Wilkin,56,17,5,78
S6735,Brenda Lake,6,36,17,59
S6736,Beverly Westra,7,57,22,86
S6737,Troy Mcmillin,16,88,84,188
S6738,Daniel Price,31,81,13,125
S6739,Roy Kenney,97,78,39,214
S6740,Brandon Woodbury,60,12,42,114
S6741,Robert Heagney,29,41,75,145
S6742,Tiffany Devane,29,44,52,125
S6743,Amanda Hobson,52,75,47,174
S6744,Kelli Mcneely,27,9,83,119
S6745,Michael Collins,86,85,96,267
S6746,Douglas Vazquez,14,8,71,93
S6747,Charlene Hardin,14,44,86,144
S6748,Margaret Gourd,85,96,93,274
S6749,Dana Thompson,29,38,82,149
S6750,Jack Jones,75,78,54,207
S6751,Christina Irving,48,69,0,117
S6752,Michael Cordoua,20,95,28,143
S6753,Wade Meyer,82,14,98,194
S6754,Robin Storms,89,43,90,222
S6755,Elton Sierra,44,22,70,136
S6756,Joanne Svec,66,86,26,178
S6757,Tarsha Lutz,0,17,38,55
S6758,Laura Smith,16,16,62,94
S6759,Lilly Luttrell,49,43,4,96
S6760,Brian Sheroan,32,29,7,68
S6761,Henry Hassinger,26,2,99,127
S6762,Roy Sexton,72,51,32,155
S6763,James Artman,75,53,21,149
S6764,Laura Lemons,51,7,34,92
S6765,Christian Lejeune,84,68,89,241
S6766,Ralph Washington,48,27,64,139
S6767,Alejandro Hayes,69,59,92,220
S6768,Sharon Melody,71,21,41,133
S6769,Betty Nelson,96,43,42,181
S6770,Hazel Ikeda,17,17,49,83
S6771,Mitchell Posey,63,32,46,141
S6772,Myrna Gheen,45,7,20,72
S6773,Max Lang,77,49,77,203
S6774,Iris Prioleau,34,55,78,167
S6775,Susan Williams,68,49,15,132
S6776,Cynthia Geren,8,34,26,68
S6777,Josephine Hobbs,53,7,58,118
S6778,Jeremy Fortier,24,26,4,54
S6779,Tammy Romito,0,19,2,21
S6780,Charlie Cower,44,8,81,133
S6781,Melissa Orr,82,59,68,209
S6782,Issac Sprinkle,75,50,89,214
S6783,Theresa Pastore,82,12,95,189
S6784,Irving James,25,22,77,124
S6785,Donna Hanson,78,35,31,144
S6786,Ralph Simpkins,15,93,92,200
S6787,Thanh Jones,88,89,50,227
S6788,Peter Segura,31,24,75,130
S6789,Stan Farris,100,27,73,200
S6790,Steven Salmon,59,30,78,167
S6791,Eddy Herbert,97,3,56,156
S6792,Matthew Gates,47,43,3,93
S6793,Travis Landsman,82,76,75,233
S6794,Dorothy Mccarty,31,23,51,105
S6795,James Watkins,43,71,76,190
S6796,Mable Gailey,33,34,44,111
S6797,Marion Velez,86,85,77,248
S6798,Rocio Nguy,0,71,50,121
S6799,Marie Savitch,82,94,25,201
S6800,Ida Thomas,63,76,8,147
S6801,Juan Rose,86,100,46,232
S6802,Luis Nielsen,65,25,74,164
S6803,Johnny Gates,54,55,88,197
S6804,Christopher Creveling,36,28,54,118
S6805,Michael Connelly,19,1,31,51
S6806,Lynne Freitas,6,39,69,114
S6807,Lucy Keith,60,53,69,182
S6808,Billy Norman,49,82,73,204
S6809,Cecilia Magallan,35,62,22,119
S6810,Michael Bly,10,87,41,138
S6811,Cheryl Whitmore,67,18,97,182
S6812,Graciela Abraham,31,88,85,204
S6813,David Gross,72,83,3,158
S6814,Erin Simonelli,71,76,93,240
S6815,James Ragland,69,95,11,175
S6816,Fred Howell,60,100,35,195
S6817,Geraldine Calhoun,61,51,52,164
S6818,Laura Davis,0,30,99,129
S6819,Renee Clark,64,64,77,205
S6820,Ella Sigler,88,51,39,178
S6821,Michele Saylor,57,14,74,145
S6822,Donna Ramirez,87,54,73,214
S6823,Jeannie Somers,78,92,23,193
S6824,Jeffery Saucier,83,86,15,184
S6825,Lesley Haskins,93,61,98,252
S6826,Alberto Brice,14,65,12,91
S6827,Donald Partee,84,59,41,184
S6828,Donald Wade,43,99,66,208
S6829,Denise Khachatoorian,22,94,83,199
S6830,Leslie Welch,72,87,44,203
S6831,Ronald Rios,52,44,24,120
S6832,Fern Riveron,27,90,18,135
S6833,Donna Davis,55,99,10,164
S6834,Clifford Carter,12,76,91,179
S6835,Courtney Wade,8,2,27,37
S6836,Dale Evans,0,93,47,140
S6837,John Stocker,39,21,70,130
S6838,John Carpenter,0,66,68,134
S6839,William Wilson,2,57,14,73
S6840,Randolph Walter,98,91,24,213
S6841,Jayne Lane,4,26,48,78
S6842,Gerald Padel,47,82,7,136
S6843,Lori Stout,89,46,60,195
S6844,Pearl Romero,31,74,19,124
S6845,Alexander Miles,99,84,2,185
S6846,Sara Masterson,94,46,68,208
S6847,Manuel Silago,78,17,48,143
S6848,Wesley Aycock,97,78,20,195
S6849,Gary Schmidtke,20,74,29,123
S6850,Mabel Janis,79,42,45,166
S6851,Randy Riley,75,89,34,198
S6852,Sherry Hudson,40,39,62,141
S6853,Alice Davis,79,91,11,181
S6854,Patrick Craig,24,1,71,96
S6855,David Payton,13,23,63,99
S6856,Sara Edge,33,88,96,217
S6857,Raymond Mulchrone,10,40,13,63
S6858,Dora Overstreet,80,86,76,242
S6859,Anna Gutierrez,10,61,35,106
S6860,Jared Moore,100,15,15,130
S6861,Francisco Brock,26,13,62,101
S6862,Joe Smith,52,65,77,194
S6863,Lillie Wilson,60,57,71,188
S6864,Margaret Taylor,0,94,62,156
S6865,Marcia Goodson,50,50,64,164
S6866,Constance Gunter,100,23,43,166
S6867,Sandra Cordier,18,33,39,90
S6868,Cary Lucas,77,58,58,193
S6869,Charles Ocasio,22,35,55,112
S6870,Ivy Maretti,67,49,88,204
S6871,Patrick Palumbo,88,76,45,209
S6872,Peter Tony,18,47,81,146
S6873,Linda Wilson,58,46,28,132
S6874,Ava Williams,29,5,96,130
S6875,Graham Durden,2,51,89,142
S6876,Alta Lopez,21,83,61,165
S6877,Clifford Meade,12,39,2,53
S6878,Doris Orio,36,56,22,114
S6879,Carl Holden,42,17,19,78
S6880,Kelly Wertheim,0,79,14,93
S6881,Derrick Cohen,35,16,97,148
S6882,Nicole Books,89,89,46,224
S6883,Zella Gionet,50,46,89,185
S6884,Melanie Willis,45,1,92,138
S6885,Michaela Schoettmer,56,21,92,169
S6886,Antonio Shoop,47,52,98,197
S6887,Richard Boykin,28,7,48,83
S6888,Stephanie Foster,62,20,5,87
S6889,Agnes Torres,42,43,58,143
S6890,Monique Franklin,15,39,9,63
S6891,Annie Perry,45,61,31,137
S6892,Donna Russ,16,55,57,128
S6893,Rose Jacques,84,87,15,186
S6894,Doug Mondragon,36,78,82,196
S6895,Francisco Lynch,49,90,75,214
S6896,Ann Sloan,53,92,95,240
S6897,William Standley,95,19,99,213
S6898,Nancy Harlin,46,8,91,145
S6899,Ashley Medeiros,66,26,66,158
S6900,Obdulia Soderlund,58,49,66,173
S6901,Ivory Buskirk,89,72,34,195
S6902,Julia Mcintosh,98,73,68,239
S6903,Carl Welker,42,43,20,105
S6904,Johnathan Garcia,27,9,52,88
S6905,Carol Ross,28,36,23,87
S6906,John Ellinger,39,98,85,222
S6907,Charles Poole,5,75,2,82
S6908,Tracy Burke,85,65,17,167
S6909,Ethel Pence,41,31,81,153
S6910,Francisca Perry,22,33,60,115
S6911,Dorothy Council,80,46,21,147
S6912,Stephen Kinsey,88,14,47,149
S6913,Guadalupe Marcella,78,69,41,188
S6914,Alvin Arnold,18,94,38,150
S6915,Bennie Quezada,10,21,38,69
S6916,Timothy Mccleary,99,63,2,164
S6917,Alvaro Lofton,83,42,34,159
S6918,Deborah Melton,79,20,45,144
S6919,Thomas Williams,4,33,42,79
S6920,Diane Curcio,44,2,30,76
S6921,Christian Baldwin,47,3,50,100
S6922,Kelli Mills,56,64,28,148
S6923,Brenda Cheng,51,24,58,133
S6924,Martha Cerda,95,15,78,188
S6925,Grace Gray,77,73,96,246
S6926,Brenda Caston,27,66,56,149
S6927,Geneva Stewart,99,25,80,204
S6928,Alberto Madden,89,32,42,163
S6929,William Thompson,72,60,16,148
S6930,Gina Clark,81,24,67,172
S6931,Marian Douglas,94,53,35,182
S6932,William Proctor,71,30,4,105
S6933,Monika Ford,69,46,74,189
S6934,Michael Whyms,74,40,93,207
S6935,Casey Damiano,30,18,99,147
S6936,Penny Killeen,67,46,2,115
S6937,Samantha Sanford,53,7,41,101
S6938,Margie Nowakowski,82,73,11,166
S6939,Michael Nieves,6,87,67,160
S6940,Jackie Licudine,61,88,34,183
S6941,Thomas Shaw,96,15,24,135
S6942,Manuel Wall,16,47,96,159
S6943,Michael Wallace,22,100,82,204
S6944,Marcia Schneider,84,1,98,183
S6945,Steven Anderson,34,74,84,192
S6946,Jon Acosta,3,30,86,119
S6947,Joel Rodriguez,44,61,13,118
S6948,Stephen Clark,87,14,52,153
S6949,Billy Choe,36,95,47,178
S6950,Marjorie Gordon,87,23,0,110
S6951,Ronald Rucker,92,67,83,242
S6952,James Scribner,64,99,59,222
S6953,Neil Diaz,67,8,1,76
S6954,Pat Vlashi,42,73,27,142
S6955,Linda Bottom,30,44,22,96
S6956,Joyce Thompson,66,65,68,199
S6957,Richard Wood,10,81,31,122
S6958,Gerardo Tambe,95,39,22,156
S6959,Dee Itson,37,11,61,109
S6960,Martin Lampl,7,45,60,112
S6961,Russell Jordan,98,39,10,147
S6962,Robert Tinley,90,11,1,102
S6963,Lynda Nichols,6,89,50,145
S6964,Christopher Saul,43,82,75,200
S6965,Donald Miller,56,17,37,110
S6966,Jeffrey Toribio,99,63,90,252
S6967,Johnny Barton,13,17,31,61
S6968,Lacy Snoddy,87,68,90,245
S6969,Carlos Elfrink,63,11,3,77
S6970,Tom Stillings,100,60,51,211
S6971,Lloyd Cooley,72,40,82,194
S6972,Jay Turner,55,36,86,177
S6973,Shawn Ericsson,77,67,86,230
S6974,Cathy Whitehead,93,73,66,232
S6975,Jerry Sipper,20,63,33,116
S6976,Eric Kelly,94,75,28,197
S6977,Robert Hanchett,67,60,95,222
S6978,Lisa Mcmillan,61,88,41,190
S6979,Michael Blackaby,77,11,74,162
S6980,Tracy Smith,47,49,29,125
S6981,Manuel Spalding,71,37,10,118
S6982,Jason Pawloski,57,4,66,127
S6983,Robert Smith,64,48,46,158
S6984,Dorothy Josey,4,8,20,32
S6985,Arthur Herring,16,36,31,83
S6986,Rudolph Lenard,71,46,63,180
S6987,Joseph Mooney,75,60,3,138
S6988,Patricia Dacus,65,19,31,115
S6989,Timothy Balder,32,40,6,78
S6990,Earl Churchwell,71,52,3,126
S6991,Clarence Zatorski,36,23,32,91
S6992,Lewis Doll,81,85,4,170
S6993,David Shore,3,14,66,83
S6994,Oscar Bishop,78,74,69,221
S6995,Mary Spaulding,8,2,48,58
S6996,Edward Overton,60,74,53,187
S6997,Kristine Escobar,73,7,87,167
S6998,Charlie Ortega,75,0,47,122
S6999,Wanda Santos,15,58,71,144
S7000,Susan Tran,36,49,44,129
S7001,Mildred Butler,27,33,22,82
S7002,Stephanie Sato,73,97,98,268
S7003,Nila Kelly,15,63,3,81
S7004,Mary Torres,59,57,16,132
S7005,Pamela Spears,78,92,1,171
S7006,Kenneth Alexander,36,100,92,228
S7007,Phyllis Oneal,93,89,0,182
S7008,Andrea Picou,95,100,54,249
S7009,Shirley Brady,40,2,90,132
S7010,Dana Scott,16,96,66,178
S7011,Nancy Burcham,36,26,84,146
S7012,John Gonzalez,18,56,41,115
S7013,Bonnie Garner,95,76,18,189
S7014,David Reynolds,26,12,5,43
S7015,Miranda Wray,15,37,19,71
S7016,Frank Carey,98,61,92,251
S7017,Fred Mcenaney,100,39,91,230
S7018,Kenneth Harrison,19,58,86,163
S7019,Thomas Weatherspoon,71,24,92,187
S7020,Teresa Warren,37,45,45,127
S7021,Valencia Pace,53,39,35,127
S7022,Ronnie Fletcher,47,97,24,168
S7023,Shannon Johnson,72,85,24,181
S7024,Timothy Stevens,54,72,16,142
S7025,Thelma Monteleone,45,72,76,193
S7026,Jeff Emanuel,92,43,15,150
S7027,John Steins,67,63,44,174
S7028,Thomas Carroll,75,35,27,137
S7029,George Adams,81,48,60,189
S7030,Jimmy Rutledge,78,41,16,135
S7031,Jeffery Santiago,50,35,79,164
S7032,David Pulido,91,79,8,178
S7033,Lawrence Santangelo,22,70,40,132
S7034,Edward Bruner,3,10,34,47
S7035,Matthew Mottet,80,35,22,137
S7036,Warren Hill,96,63,87,246
S7037,Leroy Murphy,21,21,21,63
S7038,Tina Keefe,45,1,41,87
S7039,Brenda Nunn,93,80,83,256
S7040,Lisa Nichols,5,65,60,130
S7041,Mary Cain,35,67,38,140
S7042,Eric Mcwhite,12,30,68,110
S7043,Flora Jordan,73,48,79,200
S7044,Brady Voeltner,61,11,100,172
S7045,Leroy Chatten,0,26,97,123
S7046,Gregory Wilborn,95,49,36,180
S7047,Janet Cannellos,32,31,22,85
S7048,Donald Mayo,77,72,99,248
S7049,Twila Burns,34,94,40,168
S7050,Jason Ibarra,1,24,37,62
S7051,Margaret Nance,72,82,99,253
S7052,Alfred Lueck,73,81,46,200
S7053,Bobbi Powers,36,59,33,128
S7054,Shannon Taylor,84,32,52,168
S7055,Bessie Silver,70,34,45,149
S7056,Mitchell Powers,0,26,83,109
S7057,Jonathan Stark,11,4,69,84
S7058,Alexandra Proctor,12,52,28,92
S7059,Deborah Rodriquez,42,23,62,127
S7060,David Webb,2,57,95,154
S7061,Richard Toevs,86,84,74,244
S7062,Carlos Kennedy,7,8,84,99
S7063,Jesse Carroll,36,5,63,104
S7064,Ernesto Burke,10,65,53,128
S7065,Sarah Araki,51,68,14,133
S7066,Erica Jones,17,77,70,164
S7067,Randy Vidinha,60,59,72,191
S7068,Jane Parks,26,86,72,184
S7069,Jocelyn Vasquez,5,83,5,93
S7070,Rita Campos,0,27,95,122
S7071,Bobby Perez,85,79,38,202
S7072,Helen Archuleta,55,13,23,91
S7073,Susan Vanburen,90,86,11,187
S7074,Wm Rakowski,49,27,27,103
S7075,Karen Amin,84,69,44,197
S7076,Corey Norton,44,32,52,128
S7077,Chad Gibbs,39,95,79,213
S7078,Brandy Greenleaf,70,34,54,158
S7079,Glenn Smith,33,31,57,121
S7080,Wendy Marshall,41,78,38,157
S7081,Toni Thurmond,3,23,92,118
S7082,Manuel Lamb,76,81,44,201
S7083,Karen Rodriguez,27,1,46,74
S7084,Franklin Pollard,100,67,100,267
S7085,Shirley Colvin,64,18,40,122
S7086,Denise Sun,95,81,72,248
S7087,Vera Matta,62,67,39,168
S7088,Rosemary Tuttle,85,6,68,159
S7089,Michael Wolf,25,43,52,120
S7090,Leon Neal,8,51,3,62
S7091,William Barker,25,33,15,73
S7092,Doug Thomason,45,73,24,142
S7093,Laquita Devalle,38,60,75,173
S7094,Heather Justis,70,17,37,124
S7095,Dorene David,100,61,34,195
S7096,Eric Carnahan,82,69,88,239
S7097,Jean Firth,13,15,38,66
S7098,Charles Castillo,67,73,99,239
S7099,Frank Hawkins,94,86,74,254
S7100,Diane Stamand,40,43,28,111
S7101,Russell Shaw,30,100,77,207
S7102,Mary Sargent,82,24,49,155
S7103,Tawana Kilcoyne,59,6,56,121
S7104,Mia Raxter,54,51,39,144
S7105,Pamela Jeffery,89,5,50,144
S7106,Alice Morris,30,48,53,131
S7107,Susan Kornegay,98,24,18,140
S7108,Gregory Costa,39,91,34,164
S7109,Dorothy Jean,80,97,57,234
S7110,Ashley Romon,17,13,58,88
S7111,Violet Butler,75,4,61,140
S7112,Maria Sikorski,10,1,82,93
S7113,Stephan Gary,43,62,20,125
S7114,Louise Atkins,1,44,17,62
S7115,Jessie Clark,88,72,79,239
S7116,Douglas Nadal,30,23,35,88
S7117,Danny Miller,95,27,47,169
S7118,James Bloxom,64,95,54,213
S7119,Jose Hawkins,28,22,92,142
S7120,George Johnson,1,64,68,133
S7121,Jeremy Parks,53,100,72,225
S7122,Ted Thornton,31,12,70,113
S7123,Jason Steadman,81,54,24,159
S7124,Cori Thompson,84,40,77,201
S7125,Laura Frasier,35,2,95,132
S7126,Patsy Benson,95,98,81,274
S7127,Alicia Gomez,55,22,44,121
S7128,Royce Dammeyer,91,66,95,252
S7129,Mae Doss,24,88,85,197
S7130,Jamie Stein,19,65,96,180
S7131,Adrian Smith,1,4,35,40
S7132,Anthony Harlin,20,68,55,143
S7133,William Schneider,80,3,8,91
S7134,Joseph Fulton,13,23,59,95
S7135,Georgia Goodson,26,40,5,71
S7136,Christine Jonson,45,8,26,79
S7137,Patricia Feliciano,74,75,24,173
S7138,Lee Belanger,28,84,65,177
S7139,Christine Harriott,12,90,23,125
S7140,Lindsy Key,97,69,19,185
S7141,Felicia Kearns,75,48,5,128
S7142,Rita Odum,29,67,52,148
S7143,Brian Olivas,23,80,97,200
S7144,Edwin Munguia,84,51,11,146
S7145,Jane Johnson,41,32,5,78
S7146,Mildred Rodriquez,55,10,73,138
S7147,Robert Becker,88,27,96,211
S7148,Leslie Bruner,61,84,23,168
S7149,Jacquelyn Medina,81,29,56,166
S7150,Arthur Brandon,91,49,16,156
S7151,Mary Washington,62,61,58,181
S7152,Robert Vann,88,42,37,167
S7153,Jackson Lapoint,85,81,18,184
S7154,Michael Reina,44,75,48,167
S7155,Benjamin Fox,70,47,55,172
S7156,Sonia Crawford,21,70,63,154
S7157,Barbara Steffen,35,3,43,81
S7158,Vicki Joeckel,32,81,23,136
S7159,Pam Marsh,76,94,52,222
S7160,Janice Silvera,74,41,96,211
S7161,Allison Menotti,98,3,24,125
S7162,Christopher Wong,56,8,20,84
S7163,Richard Ahrens,98,95,57,250
S7164,Jessica Henry,80,96,47,223
S7165,Maria Satterfield,2,81,48,131
S7166,Patricia Michel,31,4,98,133
S7167,Maxine Walker,8,30,65,103
S7168,Eugene Jensen,3,63,46,112
S7169,Carolyn Seiersen,23,60,5,88
S7170,Mai Stclair,80,70,18,168
S7171,Larry Stein,23,46,50,119
S7172,Clyde Terrell,100,29,42,171
S7173,Ben Canty,55,50,83,188
S7174,Chris Gutierrez,54,88,50,192
S7175,Mae Blomdahl,17,68,2,87
S7176,Betsy Jefferson,52,17,87,156
S7177,Latrice Roberts,53,33,4,90
S7178,Colin Burns,45,97,89,231
S7179,Fred Battle,1,38,6,45
S7180,Javier Turner,90,15,51,156
S7181,Mattie Halliburton,48,59,20,127
S7182,Matthew Nguyen,46,91,91,228
S7183,Catherine Alliston,64,36,43,143
S7184,Maurice Zimmerman,26,33,50,109
S7185,Michael Fields,79,96,72,247
S7186,Gary Adkins,26,47,58,131
S7187,Thomas Lopez,62,35,57,154
S7188,Jimmy Mayer,96,50,75,221
S7189,Steven Shanks,78,49,55,182
S7190,Melvina Lewis,5,27,57,89
S7191,Tommy Figueroa,100,38,60,198
S7192,Michael Williams,100,76,5,181
S7193,Thomas Hollingsworth,37,84,26,147
S7194,Paul Cloud,72,21,42,135
S7195,Clifford Broome,56,46,9,111
S7196,Lucas Stiltner,14,64,48,126
S7197,Otto Sasaki,45,49,37,131
S7198,Derrick Stout,41,74,25,140
S7199,Norma Norrod,98,64,96,258
S7200,Max Palmer,77,85,61,223
S7201,Glenda Fewell,75,85,30,190
S7202,John Pryor,65,54,35,154
S7203,Marquetta Flowers,37,27,20,84
S7204,Guy Tso,39,97,36,172
S7205,Marge Kirschner,16,57,53,126
S7206,Deirdre Neilsen,88,34,36,158
S7207,Homer Strohmeyer,12,98,35,145
S7208,Lori Kelleher,38,15,90,143
S7209,Bobby Moll,94,29,88,211
S7210,Christina Botz,19,27,25,71
S7211,Estella Nelson,89,53,62,204
S7212,Rodney Thao,14,9,68,91
S7213,Margaret Baird,89,82,20,191
S7214,Myron Argueta,39,31,85,155
S7215,Louis Johnson,36,63,19,118
S7216,Michael Rodriguez,56,52,19,127
S7217,Cristal Massey,84,75,96,255
S7218,Jessie Bowen,68,85,42,195
S7219,Susan Kiefer,86,17,65,168
S7220,Patricia Dollyhigh,48,91,82,221
S7221,Joseph Brewster,38,40,33,111
S7222,Craig Harrison,59,14,55,128
S7223,James Swindell,19,64,56,139
S7224,James Calvert,10,96,58,164
S7225,Audrey Mclellan,69,95,32,196
S7226,Matthew Johnson,63,60,75,198
S7227,Ruth Neves,93,71,25,189
S7228,Sylvia Post,74,3,82,159
S7229,Chelsea Miller,48,72,96,216
S7230,Kelly Williams,68,78,42,188
S7231,Ronnie Dean,7,95,52,154
S7232,Lisa Knowles,96,43,58,197
S7233,Bernard Puffer,46,71,34,151
S7234,Marcie Cuthbertson,53,85,51,189
S7235,Rodney Smith,74,43,74,191
S7236,Kristine Carlson,71,82,56,209
S7237,Joe Carter,39,32,76,147
S7238,Philip Whittle,73,53,81,207
S7239,Virginia Bennet,30,57,56,143
S7240,Nathaniel Haight,71,18,69,158
S7241,Becky Egge,43,78,37,158
S7242,Carol Delara,97,58,3,158
S7243,Michael Sloan,61,64,97,222
S7244,Keith Brown,9,58,100,167
S7245,Edward Riley,84,11,46,141
S7246,Valerie Roberson,94,63,84,241
S7247,Ramon Johnston,49,37,19,105
S7248,Jose Rice,72,70,52,194
S7249,Jimmy Hayes,62,78,17,157
S7250,Lillian Busby,13,32,52,97
S7251,Linda Poirier,27,95,100,222
S7252,Randy Holland,19,31,3,53
S7253,Willie Day,54,72,40,166
S7254,Craig Torres,99,51,75,225
S7255,Jessica Oneill,31,84,60,175
S7256,Fernando Parker,80,85,25,190
S7257,Brandie Long,14,30,87,131
S7258,Eleanor Johnson,99,21,40,160
S7259,Patricia Miller,81,69,82,232
S7260,Lakenya Jean,97,48,59,204
S7261,Candace Dailey,45,18,84,147
S7262,James Joffrion,43,62,39,144
S7263,Brian Castillo,67,1,74,142
S7264,Maribel Schmidt,89,41,7,137
S7265,Dane Crane,85,55,32,172
S7266,Kelly Bartlett,85,6,16,107
S7267,James Moody,16,47,26,89
S7268,Mike Gilliam,4,70,47,121
S7269,Gertrude Van,40,25,26,91
S7270,Robert Sifre,74,25,11,110
S7271,Gregory Pryce,90,26,63,179
S7272,Elizabeth Rutter,46,64,15,125
S7273,Jennifer Wright,6,28,78,112
S7274,Wade Totaro,58,18,0,76
S7275,Julie Weaver,3,26,20,49
S7276,Mary Kellner,74,38,63,175
S7277,Robin Sleiman,87,4,3,94
S7278,Jason Kinney,99,45,80,224
S7279,Mollie Sandoval,95,39,79,213
S7280,Walter Treaster,39,29,5,73
S7281,Matthew Neal,14,11,82,107
S7282,Michael Walton,5,4,70,79
S7283,Rhonda Pollard,4,90,9,103
S7284,Linda Gibbs,11,60,36,107
S7285,Gloria Liszewski,28,10,54,92
S7286,Charles Anderson,18,37,94,149
S7287,Helen Price,100,13,37,150
S7288,Henry Whittaker,65,65,46,176
S7289,Marcia Reece,87,72,34,193
S7290,Delores Calhoun,30,1,46,77
S7291,Shirley Padilla,72,70,35,177
S7292,Teddy Graves,82,94,44,220
S7293,Wallace Lail,69,100,97,266
S7294,Leslie Magnusson,67,27,36,130
S7295,Scott Schulz,94,30,86,210
S7296,Kevin Rapelyea,66,93,93,252
S7297,James Becerra,74,11,14,99
S7298,Shena Nichols,11,19,5,35
S7299,Melissa Stanton,100,27,31,158
S7300,Bernice Mccain,18,88,47,153
S7301,Carolyn Bruckner,55,37,23,115
S7302,Cathleen Southworth,55,41,21,117
S7303,Young Bunn,42,69,6,117
S7304,Preston Levine,33,35,25,93
S7305,Elvin Sylvia,40,80,12,132
S7306,Jennifer Lerma,28,76,69,173
S7307,Arturo Little,81,49,72,202
S7308,Alexis Waltman,99,1,65,165
S7309,James Lewis,23,79,47,149
S7310,Denise Cross,68,72,46,186
S7311,Christina File,26,32,67,125
S7312,Thomas Curtis,67,24,81,172
S7313,Fred Nolan,55,30,61,146
S7314,Paul Garcia,20,60,38,118
S7315,Michael Samuels,48,82,5,135
S7316,Cynthia Mathis,38,4,22,64
S7317,Christine Davila,92,84,55,231
S7318,Kevin Jones,12,51,60,123
S7319,Miriam Fowler,3,40,56,99
S7320,Theresa Hopkins,51,36,100,187
S7321,Chad Adams,50,16,70,136
S7322,Deanna Villena,3,48,47,98
S7323,Joseph Schumacher,53,73,83,209
S7324,Stacie Buck,0,26,16,42
S7325,Melissa Knight,4,56,66,126
S7326,Ann May,22,30,30,82
S7327,Andre Allison,80,72,4,156
S7328,Michelle Adams,62,57,67,186
S7329,Edmund Marks,51,49,58,158
S7330,April Murrah,20,73,98,191
S7331,Thomas Barna,78,70,81,229
S7332,Byron Rodriguez,84,10,85,179
S7333,Margaret Romero,48,80,35,163
S7334,Elizabeth Sublett,65,21,47,133
S7335,Randy Wenk,64,78,59,201
S7336,Lyla Sharrer,77,14,67,158
S7337,Jamie Leaver,6,80,69,155
S7338,Robin Stanick,53,52,57,162
S7339,Oscar Knutson,60,86,37,183
S7340,Yvonne Everett,1,50,12,63
S7341,David Johns,83,75,64,222
S7342,Micah Chitwood,42,7,10,59
S7343,Beth Carmichael,85,57,13,155
S7344,Mabel Fahy,89,32,48,169
S7345,Jamie Gall,79,40,27,146
S7346,Sheryl Davidson,75,70,95,240
S7347,Lucille Reese,80,79,13,172
S7348,Neta Hildebrand,17,57,41,115
S7349,Mark Cooper,30,41,21,92
S7350,Francis Hudkins,8,34,64,106
S7351,Lillian Upton,72,55,55,182
S7352,Sean Chantler,13,17,42,72
S7353,John Beach,19,9,26,54
S7354,Timothy Boise,52,47,34,133
S7355,Margret Akins,35,5,48,88
S7356,Marilyn Salles,80,16,14,110
S7357,Thomas Elrod,51,43,19,113
S7358,Scott Harrison,47,80,1,128
S7359,Anthony Tomlinson,46,59,48,153
S7360,Susan Clemens,32,73,12,117
S7361,Shawna Lutz,26,48,62,136
S7362,Margaret Gladden,29,31,73,133
S7363,Delia Cates,90,14,89,193
S7364,Dale Dixon,16,12,54,82
S7365,Lucy Silva,56,30,92,178
S7366,Harry Carreon,78,38,89,205
S7367,Bryan Mcmillian,12,12,2,26
S7368,Edward Curran,61,20,2,83
S7369,Maria Jordan,12,44,56,112
S7370,Robert Melton,23,93,68,184
S7371,Norman Joseph,10,86,77,173
S7372,Joann Blanc,97,37,34,168
S7373,Joseph Horne,48,85,62,195
S7374,Heather Ulloa,63,18,57,138
S7375,Jerry Edmond,79,55,100,234
S7376,Theron Bergman,41,16,2,59
S7377,Eric Huelskamp,53,88,61,202
S7378,Jeremy Ingram,80,9,0,89
S7379,Alisa Washington,48,72,68,188
S7380,Karen Culp,0,56,71,127
S7381,Jane Williams,76,70,54,200
S7382,Dawn Edwards,4,1,73,78
S7383,Daniel Hitt,69,23,0,92
S7384,Steven Byrd,16,98,68,182
S7385,Julia Ross,96,72,4,172
S7386,Jason Adams,19,67,77,163
S7387,Michael Horton,85,82,70,237
S7388,Dora Ramsey,76,83,67,226
S7389,Dwayne Clevenger,55,12,44,111
S7390,Mark Corona,31,27,84,142
S7391,Terri Mcomber,43,1,55,99
S7392,Robert Wilson,6,2,71,79
S7393,Ivy Davis,0,34,22,56
S7394,Juan Lyles,15,80,30,125
S7395,Mary Ramsey,65,95,42,202
S7396,Brian Mitchell,86,54,6,146
S7397,Carmen Comstock,21,28,8,57
S7398,Curtis Mcclain,40,26,98,164
S7399,Helen Caldwell,50,96,17,163
S7400,Gerald Gamino,42,46,92,180
S7401,Colin Barris,93,5,16,114
S7402,Thomas Preston,56,56,92,204
S7403,William Turnipseed,27,34,60,121
S7404,Ira Wheeless,37,26,46,109
S7405,Randy Siddique,15,66,2,83
S7406,Charles Fragoso,66,80,30,176
S7407,Shane Weir,46,13,15,74
S7408,Wanda Wu,1,66,71,138
S7409,Ted Bryson,94,66,0,160
S7410,Gloria Anderson,2,57,40,99
S7411,Larry Mangini,84,82,87,253
S7412,Terry Hurley,32,50,51,133
S7413,James Goforth,79,99,83,261
S7414,Gary Johns,20,42,45,107
S7415,Gloria Matson,87,69,69,225
S7416,Kimberly Stange,53,20,95,168
S7417,Robert Johnson,58,20,64,142
S7418,Maria Witt,48,89,100,237
S7419,Julia Molina,56,0,91,147
S7420,Peter Rooney,16,60,85,161
S7421,Jean Richardson,64,41,83,188
S7422,Jessica Flansburg,92,18,86,196
S7423,Tina Monteleone,90,25,98,213
S7424,Lucille Sullivan,91,93,1,185
S7425,Norman Egbert,84,1,70,155
S7426,Ricky Bandy,71,11,38,120
S7427,Eric Eason,69,44,93,206
S7428,Bernadette Robinson,13,64,69,146
S7429,Prince Ortiz,67,82,100,249
S7430,Charlene Erwin,44,39,6,89
S7431,Gerald Moore,73,88,35,196
S7432,John Burns,5,84,30,119
S7433,Buster Thorpe,57,82,51,190
S7434,Ignacio Adu,47,25,2,74
S7435,Edwin Masser,38,79,80,197
S7436,Dennis Santiago,12,13,21,46
S7437,Paul Lawrence,56,0,58,114
S7438,Mark Thomas,75,36,41,152
S7439,John Ray,24,71,59,154
S7440,Stella Sim,81,41,33,155
S7441,Carolyn Hoelscher,95,19,10,124
S7442,Irma Wood,57,51,55,163
S7443,William Nelson,38,60,90,188
S7444,Chelsea Rush,73,42,43,158
S7445,Derick Martinez,65,33,30,128
S7446,Melissa Hua,74,12,16,102
S7447,William Martinez,84,48,97,229
S7448,Kay Ramirez,7,36,7,50
S7449,Carrie Converse,17,90,47,154
S7450,Donna Almonte,78,65,99,242
S7451,Jason Wilks,13,33,3,49
S7452,Peggy Downer,43,95,9,147
S7453,Amanda Goodin,97,0,17,114
S7454,Donald Bennington,84,13,68,165
S7455,Henry Wardwell,7,30,16,53
S7456,Wayne Hill,69,98,78,245
S7457,Carlos Walker,14,25,9,48
S7458,Stuart Taylor,45,94,60,199
S7459,Debra Calloway,82,33,77,192
S7460,April Felix,87,29,68,184
S7461,Gary Perez,84,55,97,236
S7462,Della Chall,30,27,28,85
S7463,Carlos Londono,92,68,57,217
S7464,Rebecca Oliver,84,5,66,155
S7465,Lindsay Hotchkiss,37,25,66,128
S7466,Rhonda Murphy,47,69,23,139
S7467,Olivia Gillman,29,13,28,70
S7468,Gerald Bohannon,0,34,75,109
S7469,Mark Langhans,33,53,83,169
S7470,Christine Hopkins,85,74,29,188
S7471,Michael Zemel,46,67,37,150
S7472,Christina Stover,16,69,93,178
S7473,Dan Skinner,29,68,59,156
S7474,Elizabeth Brannan,12,61,78,151
S7475,Lydia Hammons,75,16,85,176
S7476,David Mills,99,0,10,109
S7477,Brandon Seay,5,11,93,109
S7478,Lisa Ferguson,54,91,38,183
S7479,Maria Adams,43,70,98,211
S7480,Kenneth Dick,26,42,67,135
S7481,Brian Morton,14,29,30,73
S7482,Debra Foersterling,15,47,44,106
S7483,Dawn Gronlund,20,53,47,120
S7484,Donald Kirkland,52,96,42,190
S7485,William Sharpe,87,3,25,115
S7486,Terri Peebles,97,42,78,217
S7487,Lloyd Alexander,60,81,83,224
S7488,Kenneth Richard,78,9,75,162
S7489,Cecilia Moore,98,62,77,237
S7490,Maria Vela,17,61,54,132
S7491,Annetta Cottrell,35,71,46,152
S7492,Mildred Wood,63,53,16,132
S7493,Lillian Hunter,11,27,70,108
S7494,Timothy Ikeda,91,20,97,208
S7495,Linda Hines,64,69,67,200
S7496,Kim Hayes,57,1,32,90
S7497,Debra Parks,6,59,7,72
S7498,Nickolas Dense,87,76,44,207
S7499,Sharon Shay,29,28,79,136
S7500,Carl Watland,19,46,89,154
S7501,Tony Teasley,39,8,30,77
S7502,Norman Garcia,8,19,55,82
S7503,Kayla Ward,87,64,33,184
S7504,Peter Perez,5,97,98,200
S7505,Mary Walters,87,90,29,206
S7506,Benjamin Liedtke,44,49,45,138
S7507,Marry Stoll,45,31,5,81
S7508,Amy Ortiz,26,34,57,117
S7509,Brian Young,93,66,41,200
S7510,Jordan Scheumann,32,8,63,103
S7511,James Thurmond,58,91,42,191
S7512,Mayme Johnson,52,30,77,159
S7513,George Lehman,3,89,15,107
S7514,William Hatton,34,52,38,124
S7515,Malka Wildes,52,0,2,54
S7516,Leonardo Widen,34,48,8,90
S7517,William Gill,45,52,40,137
S7518,Gladys Smith,57,70,92,219
S7519,Robert Newcomer,67,67,49,183
S7520,Jeanine Long,12,87,1,100
S7521,Brigitte Granados,1,37,51,89
S7522,Kathleen Chick,37,88,53,178
S7523,Jason Hawkins,42,6,45,93
S7524,Walter Evans,1,1,34,36
S7525,George Walt,32,77,70,179
S7526,Edward Doak,85,30,99,214
S7527,Kristopher Galvan,48,68,69,185
S7528,Vernon Krahn,11,84,12,107
S7529,Randi Graham,10,20,2,32
S7530,Stuart Gomez,39,78,50,167
S7531,Barbara Nockels,22,98,82,202
S7532,Megan Assante,88,82,0,170
S7533,Henry Tatum,99,11,50,160
S7534,Mary Kuntz,31,42,68,141
S7535,Joseph Mcguire,90,24,20,134
S7536,Steven Reyes,74,64,29,167
S7537,Marlene Ball,45,98,39,182
S7538,Edward Mojica,83,88,49,220
S7539,Rosalina Avila,32,47,75,154
S7540,Richard Lenox,40,83,93,216
S7541,Jonathan Downey,9,87,68,164
S7542,Marguerite Footman,15,40,73,128
S7543,Michael Folden,55,14,52,121
S7544,Sherry Stuart,29,62,11,102
S7545,Rocio Novak,93,1,3,97
S7546,Jose Groff,97,39,49,185
S7547,Eric Severs,17,27,61,105
S7548,Emma Christian,57,88,9,154
S7549,Dan Tyler,45,22,12,79
S7550,John Saucedo,64,20,78,162
S7551,Lisa Long,13,15,50,78
S7552,Marcus Ollendick,73,33,28,134
S7553,Damon Lavallee,49,49,12,110
S7554,Edward Ates,50,96,49,195
S7555,Sandra Smallwood,30,82,100,212
S7556,Guy Wood,75,41,52,168
S7557,Gina Allen,13,9,92,114
S7558,Elke Andrew,29,31,40,100
S7559,Natalie Mark,47,82,9,138
S7560,Calvin Hoffman,30,22,29,81
S7561,Ocie Argabright,70,61,97,228
S7562,Reginald Butler,57,83,38,178
S7563,Fred Warner,38,44,19,101
S7564,Kathy Ray,22,36,32,90
S7565,Christine Kruse,11,73,26,110
S7566,Scott Foy,94,48,15,157
S7567,Rodolfo Tunstall,13,79,52,144
S7568,Aaron Harada,93,57,68,218
S7569,Jenny Sanchez,57,60,90,207
S7570,Danial Whitehead,15,17,33,65
S7571,Carole Strickland,2,8,98,108
S7572,Russell Gomez,59,45,84,188
S7573,Charles Robinson,67,32,20,119
S7574,Daniel Coles,80,60,91,231
S7575,Loretta Gries,16,71,85,172
S7576,Terry Compton,66,86,54,206
S7577,Robert Tatsch,17,44,6,67
S7578,Bernadine Lunsford,63,48,87,198
S7579,Hubert Tovar,74,56,90,220
S7580,Clayton Melchior,51,51,11,113
S7581,Kathryn Melton,52,94,87,233
S7582,Allen Isom,65,89,5,159
S7583,Bobby Smart,74,5,92,171
S7584,Hunter Robertson,54,38,32,124
S7585,Roberta Kirkland,66,73,18,157
S7586,William Durkin,53,51,98,202
S7587,Frank Benscoter,40,96,30,166
S7588,Phillip Stallard,31,6,65,102
S7589,John Morgan,44,82,21,147
S7590,Richard Karth,47,46,0,93
S7591,Debra King,68,35,63,166
S7592,Robert Gregory,24,48,91,163
S7593,Maria Quinn,25,19,83,127
S7594,Roger Rivira,8,70,36,114
S7595,Kyle Terrell,25,3,64,92
S7596,Pauline Patterson,49,12,50,111
S7597,Dwayne Boutwell,25,86,97,208
S7598,Rose Burger,35,54,60,149
S7599,Diane Cranford,60,96,7,163
S7600,Gregg Brooks,6,20,10,36
S7601,Milton Presto,24,20,13,57
S7602,Donald Moore,12,52,76,140
S7603,Patricia Ferrin,51,98,70,219
S7604,Robert Liss,12,28,64,104
S7605,Rick Thompson,73,97,63,233
S7606,William Torres,93,69,15,177
S7607,Terry Johnson,18,17,86,121
S7608,Judy Collado,85,83,1,169
S7609,George Howard,68,31,0,99
S7610,Freddie Lininger,29,75,10,114
S7611,Jason Johnson,88,44,100,232
S7612,Johnny Sisneros,22,1,19,42
S7613,Jason Taylor,20,16,81,117
S7614,Cathy Liles,62,16,85,163
S7615,Eva Bowman,94,3,75,172
S7616,William Toman,75,55,0,130
S7617,Keith Flower,25,13,41,79
S7618,Kathryn Freeman,45,85,53,183
S7619,Patricia Williams,75,92,18,185
S7620,Christopher Dawson,4,9,91,104
S7621,Charles Gafford,55,46,67,168
S7622,Maggie Ingle,1,34,44,79
S7623,Yuette Priester,16,89,22,127
S7624,Stephanie Boling,28,72,33,133
S7625,Jennifer Fogg,66,81,36,183
S7626,Majorie Thrasher,31,26,72,129
S7627,Jessica Rogers,72,70,19,161
S7628,Thomas Yadao,9,53,64,126
S7629,Marion Mitchell,1,68,7,76
S7630,Dominic Smith,58,100,4,162
S7631,Virginia Milton,55,58,79,192
S7632,Thomas Carlton,46,51,63,160
S7633,Harold Mcmurray,22,81,8,111
S7634,Diann Powell,51,45,91,187
S7635,France Mccutcheon,26,6,22,54
S7636,Stacy Hayne,32,49,70,151
S7637,Martha Stokes,13,6,6,25
S7638,Betty Bleau,61,61,44,166
S7639,Sherry Benson,5,43,48,96
S7640,Nancy Ellis,2,94,70,166
S7641,Adam Dean,24,5,32,61
S7642,Julia Herr,72,96,37,205
S7643,Rhonda Anderson,0,28,74,102
S7644,John Depner,12,40,48,100
S7645,Mary Mcleod,95,73,35,203
S7646,Lawrence Barnes,47,64,49,160
S7647,Laura Walden,0,18,94,112
S7648,Gerald Fyall,23,26,30,79
S7649,Robert Smith,70,11,43,124
S7650,Sylvia Arkenberg,16,28,41,85
S7651,Steven Cropper,85,12,23,120
S7652,Tisha Plymel,75,85,77,237
S7653,Nancy Correia,17,46,58,121
S7654,Deon Boling,91,89,34,214
S7655,Ann Murphy,65,19,53,137
S7656,Robert Davis,57,2,16,75
S7657,Gustavo Conley,11,5,72,88
S7658,Mary Cregan,83,47,17,147
S7659,Colby Landis,27,65,28,120
S7660,David Featherston,3,96,8,107
S7661,Blanche Shipman,61,73,100,234
S7662,Ilene Knobbe,82,56,97,235
S7663,John Bergman,80,15,53,148
S7664,Thomas Obrien,12,34,9,55
S7665,Billy Valdez,49,15,64,128
S7666,Scott Kimbro,63,39,64,166
S7667,Janet Mcdevitt,26,7,96,129
S7668,Myrtle Husted,26,5,100,131
S7669,Bryan Alpert,77,92,52,221
S7670,Mark Lake,61,76,40,177
S7671,Anna Mccormack,60,27,74,161
S7672,Shane Stone,35,27,35,97
S7673,Larry Gillikin,34,40,18,92
S7674,David Schultz,22,21,42,85
S7675,Marnie Getz,25,10,73,108
S7676,Jeff Porter,51,85,85,221
S7677,Ernest Peyton,77,47,11,135
S7678,Ila Fenton,54,21,15,90
S7679,Daniel Bell,4,26,48,78
S7680,Pricilla Kuhl,33,40,79,152
S7681,Diane Groves,99,62,62,223
S7682,Harold Stein,99,14,22,135
S7683,Holly Neal,92,77,75,244
S7684,Bessie Wallace,83,35,42,160
S7685,Robert Castillo,5,55,82,142
S7686,Vince Vandamme,3,79,25,107
S7687,Brenda Waldvogel,83,48,64,195
S7688,Essie Warren,21,2,30,53
S7689,Tomasa Walters,25,81,35,141
S7690,Bonnie Thornton,94,55,75,224
S7691,Michaela Gordy,41,19,62,122
S7692,Minnie Gove,48,44,78,170
S7693,Jose Ling,37,30,59,126
S7694,Dennis Williams,5,42,61,108
S7695,Dana Halcomb,81,43,84,208
S7696,Joshua Roe,79,95,84,258
S7697,Drew Klyce,8,1,48,57
S7698,Jonathan Thompson,77,36,89,202
S7699,Hazel Drumm,21,82,25,128
S7700,Mary Sisco,48,54,85,187
S7701,Thomas Berthiaume,86,25,92,203
S7702,Donald Jordan,28,45,36,109
S7703,Catherine Combs,23,93,26,142
S7704,Shirley Heckard,12,17,76,105
S7705,Tom Morrison,54,27,71,152
S7706,John Owens,18,21,2,41
S7707,Emanuel Zambrano,84,46,83,213
S7708,Jerome Pouliot,83,35,76,194
S7709,Marty Baker,11,80,64,155
S7710,Kimberley Martineau,17,0,81,98
S7711,Roger Becerra,68,18,81,167
S7712,Daniel Mouton,10,35,73,118
S7713,Michael Goldstein,6,63,36,105
S7714,Peter Lewis,48,35,63,146
S7715,Margaret Burleson,9,51,18,78
S7716,Gloria Clagon,29,74,80,183
S7717,Sarah Campbell,96,8,87,191
S7718,Efrain Shelnutt,4,35,85,124
S7719,Lara Pinkett,44,58,58,160
S7720,Rosetta Greene,12,25,35,72
S7721,Mary Waters,41,5,5,51
S7722,Michael Bunch,29,91,46,166
S7723,Shawn Campbell,90,13,16,119
S7724,Donna Copley,11,25,95,131
S7725,Richard Chatten,71,48,61,180
S7726,Truman Utter,82,90,53,225
S7727,Eugene Allen,24,14,0,38
S7728,Ian Miller,34,42,95,171
S7729,Dean Leaf,16,46,96,158
S7730,Carmen Vansumeren,67,32,74,173
S7731,Patricia Fitch,76,83,4,163
S7732,Teresa Jacobs,43,2,30,75
S7733,Nathan Sullivan,62,23,14,99
S7734,Emma Choate,2,8,50,60
S7735,Thomas Rose,42,27,38,107
S7736,Mike Belcher,67,84,5,156
S7737,Albert Bond,20,98,46,164
S7738,Thomas Sullens,81,70,44,195
S7739,Nancy Lindsey,84,13,53,150
S7740,Robert Valentine,98,92,40,230
S7741,Matthew Syphers,46,78,89,213
S7742,Adam Porras,19,10,54,83
S7743,Teresa Sanders,57,36,87,180
S7744,Lillian Saulsberry,81,41,97,219
S7745,Sharon Mccombs,67,40,43,150
S7746,Elizabeth Kelly,35,12,100,147
S7747,Helen Pool,69,76,49,194
S7748,Mathew Stamper,34,4,31,69
S7749,Dwight Holston,0,95,22,117
S7750,Margaret Reeks,16,88,26,130
S7751,Monty Troupe,70,21,86,177
S7752,Gloria Emery,76,100,7,183
S7753,Thomas Lostroh,35,84,82,201
S7754,Kayleen Lipscomb,49,11,76,136
S7755,Victoria Redmond,22,71,65,158
S7756,Ray Crowe,83,47,34,164
S7757,Debra Hobbs,8,28,100,136
S7758,Zachary Torres,84,81,63,228
S7759,Marie Richey,64,92,41,197
S7760,Stanley Langel,87,81,0,168
S7761,Johnny Schreyer,6,98,83,187
S7762,Ronald Nelson,1,46,12,59
S7763,Elizabeth Mcdonald,78,19,19,116
S7764,Aida Schmidt,67,54,11,132
S7765,Suzanne Eligio,16,66,26,108
S7766,Anthony Hall,27,97,85,209
S7767,Luann Larve,37,83,85,205
S7768,Willie Hawkins,41,86,66,193
S7769,Agnes Torbus,72,48,63,183
S7770,Timothy Mclain,93,40,57,190
S7771,Vincent Kramer,47,32,83,162
S7772,George Neil,70,97,71,238
S7773,Teresa Lacomb,65,1,76,142
S7774,William Ellington,28,70,10,108
S7775,Rachel Kuhn,43,60,33,136
S7776,Harvey Dipaola,55,57,10,122
S7777,Christopher Moore,8,78,16,102
S7778,Kathleen Sells,0,53,91,144
S7779,Mary Mclaughlin,44,31,58,133
S7780,Rachel English,34,94,1,129
S7781,Lewis Johnson,88,69,42,199
S7782,Richard Issa,72,0,60,132
S7783,Tracy Clark,24,65,93,182
S7784,Jennifer Miller,80,14,41,135
S7785,Mary Aviles,95,65,34,194
S7786,Gary Bailey,58,74,17,149
S7787,Todd Littman,57,26,45,128
S7788,Dana Hudson,73,43,71,187
S7789,Angela Hayes,72,9,95,176
S7790,Jamel Whalen,100,49,37,186
S7791,Dale Sandy,12,24,34,70
S7792,Queen Garza,94,15,9,118
S7793,Joshua Mckennon,44,10,71,125
S7794,Kelly Richter,90,53,36,179
S7795,Mike Herndon,85,34,90,209
S7796,Mamie Shaver,16,99,26,141
S7797,Rhonda Walker,81,79,45,205
S7798,Debbie Flores,12,38,79,129
S7799,Kathryn Wilson,36,54,99,189
S7800,Alene Moore,94,28,71,193
S7801,Paula Jackson,35,63,64,162
S7802,Anna Hansen,91,9,16,116
S7803,John Wade,31,2,67,100
S7804,Dorian Lewis,51,51,28,130
S7805,John Thornton,71,80,78,229
S7806,Robert Fulghum,70,48,38,156
S7807,John Gonzalez,53,30,55,138
S7808,Mike Rodriguez,92,5,16,113
S7809,George Alexander,56,17,1,74
S7810,Ada Smith,15,28,77,120
S7811,John Glenn,11,34,62,107
S7812,Simone Simpson,52,59,13,124
S7813,Carol Friend,16,56,1,73
S7814,Melinda Love,46,31,58,135
S7815,Stacey Venable,55,41,38,134
S7816,Nancy Howell,72,64,67,203
S7817,Robert Hurley,1,82,24,107
S7818,Scott Cancilla,82,65,44,191
S7819,Angela Nash,44,7,73,124
S7820,David Powers,39,15,44,98
S7821,Lelah Torres,36,16,97,149
S7822,Jason Hafer,24,57,42,123
S7823,Victor Recuparo,36,97,15,148
S7824,Greg Vargas,32,87,14,133
S7825,Kenneth Campos,20,14,33,67
S7826,Travis Sailor,21,24,85,130
S7827,Henry Johnson,35,81,99,215
S7828,Albert Hall,24,90,77,191
S7829,Eugene Limbo,51,23,58,132
S7830,Bryan Darroch,76,96,22,194
S7831,Augustus Pugh,30,39,48,117
S7832,Shelley Heitman,76,93,35,204
S7833,Patricia Spann,97,68,71,236
S7834,Alice Taylor,98,3,24,125
S7835,Robert Thompson,71,5,60,136
S7836,Stephanie Mccormick,79,71,31,181
S7837,Thomas Vanpelt,6,7,23,36
S7838,Carl Wallace,84,94,69,247
S7839,Rebecca Ramsey,44,34,84,162
S7840,Rhonda Green,49,71,84,204
S7841,Nicholas Harris,46,97,13,156
S7842,Jenna Tousom,0,4,79,83
S7843,Shawn Mellow,68,57,56,181
S7844,Keith Holloway,3,16,28,47
S7845,Ray Zane,63,49,87,199
S7846,Sandra Jones,29,39,73,141
S7847,Kevin Gattison,66,48,6,120
S7848,Jennifer Davis,40,45,1,86
S7849,Linda Greaves,74,6,71,151
S7850,Sidney Newcomb,38,21,11,70
S7851,Robert Moseley,33,13,72,118
S7852,Vincent Medina,16,92,41,149
S7853,Brent Thompson,70,22,96,188
S7854,Kelly Stoffregen,3,29,54,86
S7855,Dona Jackson,56,13,91,160
S7856,Timothy True,71,11,15,97
S7857,Kimberly Trias,0,51,87,138
S7858,Robert Hough,1,20,91,112
S7859,Theresa Shows,3,24,88,115
S7860,Maria Rollyson,24,54,52,130
S7861,Ivy Wheeler,42,9,55,106
S7862,Miguel Harkin,29,69,62,160
S7863,Jerri Weber,50,76,37,163
S7864,Bruce Spatz,20,85,15,120
S7865,Richard Bunn,23,90,74,187
S7866,Bertram Brenton,79,54,10,143
S7867,Anita Beaver,53,44,6,103
S7868,Julie Arneson,87,14,4,105
S7869,Frank Dorman,38,48,70,156
S7870,Joe Ramsey,63,41,16,120
S7871,Kristen Huneycutt,51,38,56,145
S7872,Liza Wolfe,15,96,65,176
S7873,Scott Grimes,89,47,64,200
S7874,David Otting,90,21,88,199
S7875,Pamala King,28,29,14,71
S7876,Elmer Wiggins,69,39,57,165
S7877,Laura Silva,32,11,38,81
S7878,Audrey Snow,28,1,11,40
S7879,Tasha Stello,56,0,15,71
S7880,Larry Kinchen,96,0,8,104
S7881,Marcelle Herron,100,71,96,267
S7882,Byron Gil,46,87,97,230
S7883,Allen Snell,83,50,71,204
S7884,Harry Trantham,63,53,80,196
S7885,Michael Kuester,31,21,54,106
S7886,Mark Morton,41,81,92,214
S7887,Jimmy Reynolds,98,87,54,239
S7888,John Thomas,51,37,79,167
S7889,Gabriel Orsborn,21,97,40,158
S7890,Lavina Gow,69,48,46,163
S7891,Mary Espinosa,75,62,80,217
S7892,Mary Chiarello,54,20,58,132
S7893,Luisa Ness,82,1,87,170
S7894,Richard Scott,15,48,57,120
S7895,Allen Plantz,64,60,27,151
S7896,Mark Kennedy,70,35,20,125
S7897,Ricardo Wordsworth,59,69,56,184
S7898,Annette Kavanaugh,99,88,8,195
S7899,Vicki Harris,31,82,89,202
S7900,Amanda Williford,92,79,52,223
S7901,Toni Stout,81,86,66,233
S7902,Stephen Nieves,73,37,85,195
S7903,Demetrice Monopoli,70,82,75,227
S7904,Ruth Bryant,86,19,19,124
S7905,Mary Key,35,34,18,87
S7906,Fernando Morgan,86,17,53,156
S7907,June Huntington,53,16,52,121
S7908,Lamont Gordon,27,30,85,142
S7909,Leo Taylor,37,24,47,108
S7910,Penny Flores,80,29,15,124
S7911,Carol Nall,62,63,75,200
S7912,Barbara Larkin,88,82,11,181
S7913,Sherry Craft,83,54,1,138
S7914,Thomas Varnell,34,23,46,103
S7915,Lois Artis,68,66,12,146
S7916,Wilma Fallin,31,41,74,146
S7917,Norma Ford,58,72,49,179
S7918,Ruth Beckwith,65,30,89,184
S7919,John Mcmillan,37,11,35,83
S7920,Richard Holder,86,1,0,87
S7921,Robert Roller,86,17,57,160
S7922,Fay Blankenship,77,4,64,145
S7923,Madeline Weitz,95,60,57,212
S7924,John Williams,80,23,4,107
S7925,Fay Marsh,25,71,97,193
S7926,John Pereira,33,22,65,120
S7927,Don Hebert,61,45,67,173
S7928,Steven Decamp,72,60,37,169
S7929,Myrtle Bear,67,7,33,107
S7930,Ana Preston,79,4,23,106
S7931,James Scott,20,37,99,156
S7932,Jean Maldonado,49,8,46,103
S7933,Morris Odom,92,81,52,225
S7934,William Bratcher,58,23,14,95
S7935,Pamela Perry,52,23,5,80
S7936,Clara Cameron,62,70,80,212
S7937,Michelle Rohlfing,89,98,88,275
S7938,Steven Richey,31,71,8,110
S7939,Carmen Poole,65,82,34,181
S7940,Bryan Rodriguez,83,26,23,132
S7941,Alfredo Axel,8,21,51,80
S7942,Kimberly Lamb,53,99,22,174
S7943,Claudia Shaw,64,54,74,192
S7944,Steven Fagan,91,78,50,219
S7945,James Conway,97,1,67,165
S7946,Demetrius Markrof,98,16,14,128
S7947,George Mcalpin,16,88,34,138
S7948,Jesus Thompson,84,96,53,233
S7949,Deborah Bowen,88,30,40,158
S7950,June Moore,54,16,34,104
S7951,Keri Sedillo,79,50,76,205
S7952,Kellee Post,1,100,24,125
S7953,Joshua Robertson,92,83,81,256
S7954,Anne Blackwell,65,71,79,215
S7955,Eileen Madison,33,25,44,102
S7956,Jorge Holley,61,27,68,156
S7957,Michael Ramsey,61,19,80,160
S7958,Aletha Vanburen,48,82,91,221
S7959,Valerie Pitcherello,98,91,10,199
S7960,Dewayne Mitchell,27,26,89,142
S7961,Priscilla Robles,30,13,19,62
S7962,Harold Towe,79,73,55,207
S7963,Jennifer Graham,24,99,81,204
S7964,William Harmon,80,34,49,163
S7965,Regina Smith,74,68,65,207
S7966,Katharine Peterson,81,27,72,180
S7967,Kathleen Hicks,34,57,70,161
S7968,Jorge Williamson,56,75,47,178
S7969,Katheleen Quilliams,14,78,39,131
S7970,Betty Wells,53,55,53,161
S7971,Deborah Mcintyre,16,0,74,90
S7972,Mary Ruiz,100,74,59,233
S7973,Kristine Francese,43,44,58,145
S7974,Terri Reynoso,85,36,41,162
S7975,Jeff Dorst,62,16,24,102
S7976,Jesusa Roques,78,68,6,152
S7977,Ernest Burton,100,41,83,224
S7978,Hazel Joseph,28,81,45,154
S7979,Hunter Jones,17,39,84,140
S7980,Alfonso Douglas,8,29,90,127
S7981,Kristen Galvan,39,1,84,124
S7982,Johnny Allender,90,93,4,187
S7983,David Duran,66,54,17,137
S7984,Elizabeth Smith,41,0,42,83
S7985,Stacey Garrett,8,94,3,105
S7986,Monique Cockerham,71,90,61,222
S7987,Virginia Jenkins,9,15,36,60
S7988,Jill Stokley,58,2,47,107
S7989,Don Perryman,97,65,67,229
S7990,Heather Ridgway,15,0,15,30
S7991,Shelley Means,66,39,97,202
S7992,Sally Pawloski,88,58,14,160
S7993,Robert Wells,4,4,1,9
S7994,Edward Gray,98,86,70,254
S7995,Frank Swingle,92,47,36,175
S7996,Harold Enders,26,97,93,216
S7997,Jennie Eckert,84,95,38,217
S7998,Carol Marshall,11,67,87,165
S7999,Dorothy Brown,49,29,17,95
S8000,John Collins,16,17,41,74
S8001,Mary Williams,47,31,99,177
S8002,Donald Huse,62,12,52,126
S8003,Donald Jackson,23,63,49,135
S8004,William Marsh,45,33,15,93
S8005,Mark Money,37,49,67,153
S8006,Wanda Garner,96,100,1,197
S8007,Maureen Myers,5,35,7,47
S8008,Ambrose Walker,51,54,17,122
S8009,Ruth Legrand,44,43,25,112
S8010,Danielle Larson,58,8,25,91
S8011,Harry Scorgie,39,58,68,165
S8012,Daniel Polston,24,7,2,33
S8013,Dwight Batten,93,30,87,210
S8014,Gary Anderson,50,72,29,151
S8015,Charlene Glasgow,16,52,71,139
S8016,James Norton,10,20,92,122
S8017,Debra Barnett,42,17,72,131
S8018,Michael Shea,90,3,39,132
S8019,Leon Milan,68,66,31,165
S8020,Sam Mackson,21,36,96,153
S8021,Lora Barna,88,90,95,273
S8022,William Hall,85,87,44,216
S8023,Elizabeth Daddio,59,12,57,128
S8024,Kathleen Andino,33,23,3,59
S8025,Erna Morgan,31,46,22,99
S8026,Sherry Martinez,27,44,24,95
S8027,Manuel Jackson,2,96,84,182
S8028,David Gillenwater,15,49,15,79
S8029,Jesus Flory,26,88,4,118
S8030,Deanna Johnson,89,49,52,190
S8031,Jose Smith,26,28,87,141
S8032,Freddie Mccullers,94,42,14,150
S8033,Agnes Anderson,56,26,50,132
S8034,Raymond Zapata,49,99,52,200
S8035,Shirley Acree,46,85,21,152
S8036,Brian Watson,39,26,97,162
S8037,Linda James,90,38,53,181
S8038,James Ventura,41,48,90,179
S8039,Robert Koelling,22,46,45,113
S8040,Kenneth Ballew,17,55,2,74
S8041,William Hartman,88,12,44,144
S8042,Jeffry Krob,24,46,30,100
S8043,David Hebert,30,16,88,134
S8044,Santos Albert,59,98,78,235
S8045,Gary Tobin,82,76,65,223
S8046,Robert Valente,25,86,34,145
S8047,Anthony Kehres,41,50,71,162
S8048,Essie Holman,98,19,86,203
S8049,Joseph Treisch,63,64,34,161
S8050,Frederick Cronin,42,54,98,194
S8051,Frank Clayton,36,77,48,161
S8052,Thomas Kruger,3,43,40,86
S8053,Brian Allen,31,46,53,130
S8054,Brandon Palomo,55,89,38,182
S8055,Jennifer Wood,62,18,29,109
S8056,James Hull,84,28,61,173
S8057,James Mckee,92,55,78,225
S8058,Louann Jones,18,50,90,158
S8059,Tanya Winslow,26,92,57,175
S8060,Duane Mccarty,25,59,36,120
S8061,Ariel Nguyen,79,48,74,201
S8062,Jessica Rolen,64,46,24,134
S8063,Allen Montoya,62,51,30,143
S8064,Orlando Murphy,74,97,97,268
S8065,Mary Russell,79,66,65,210
S8066,Alexander Johnson,2,65,91,158
S8067,Kevin Jennings,95,45,76,216
S8068,April Copeland,55,43,100,198
S8069,Lelia Farley,56,24,10,90
S8070,Samuel Mccandless,83,66,61,210
S8071,Roger Nix,70,54,100,224
S8072,Robert Owens,44,84,39,167
S8073,Yvette Ceron,95,8,0,103
S8074,Michael Caballero,24,81,57,162
S8075,Kelli Hunt,94,6,32,132
S8076,Carmelo Depeyster,61,94,89,244
S8077,Chantel Knox,83,36,94,213
S8078,Jeanne Hampton,84,39,35,158
S8079,Wilma Dobbins,68,92,29,189
S8080,Brittney Gullixson,14,46,78,138
S8081,Fredrick Remmers,91,76,58,225
S8082,Jose Williams,29,63,33,125
S8083,Kenneth Gomez,36,17,94,147
S8084,Anna Allen,61,59,35,155
S8085,Jose Hudnell,54,21,22,97
S8086,Melissa Davis,18,28,29,75
S8087,Robert Harris,90,47,54,191
S8088,Shirley Griffiths,90,94,45,229
S8089,Susan Russell,40,48,57,145
S8090,Al Clark,83,39,71,193
S8091,Lisa Withem,5,4,48,57
S8092,Dana Scales,100,71,70,241
S8093,Leslie Henricks,19,90,58,167
S8094,Lilly Miramon,75,31,85,191
S8095,Dominick Rowe,30,17,83,130
S8096,Brent Hawley,18,60,47,125
S8097,Leroy Gutierrez,32,36,77,145
S8098,Trina Eastes,2,82,91,175
S8099,Sandra Cano,76,42,47,165
S8100,Amanda Coney,13,100,75,188
S8101,Bernice Dalessandro,81,15,82,178
S8102,Joseph Pollard,91,33,4,128
S8103,Robert Lee,13,11,10,34
S8104,George Phillips,0,31,63,94
S8105,Thelma Jones,14,36,70,120
S8106,Barry Valladares,65,52,86,203
S8107,Joyce Calloway,86,14,50,150
S8108,Milissa Paredez,36,93,99,228
S8109,Scott Hartsock,37,0,65,102
S8110,Gina Clowes,21,35,63,119
S8111,Olinda Mency,26,0,91,117
S8112,Wanda Broaddus,19,43,0,62
S8113,June Hahn,5,1,15,21
S8114,Sheryl Langholz,34,4,41,79
S8115,Amanda Briski,1,23,47,71
S8116,Steven Bossler,83,28,73,184
S8117,Lisa Vasquez,96,25,71,192
S8118,John Acevedo,48,35,16,99
S8119,Charles Ward,34,57,7,98
S8120,Jean Dias,85,28,54,167
S8121,Carlos Moore,20,19,14,53
S8122,Ruth Jones,94,43,56,193
S8123,Alfred Branch,9,33,68,110
S8124,Tracey Josselyn,84,88,74,246
S8125,Jorge Barela,4,74,60,138
S8126,Bradley Fornes,3,42,73,118
S8127,William Cooper,21,95,59,175
S8128,Wilfredo Olague,52,19,53,124
S8129,Chris Williams,93,79,21,193
S8130,Patricia Dawson,48,87,95,230
S8131,Tammy Russel,21,16,61,98
S8132,Martha Kidd,73,81,49,203
S8133,Dave Douglas,68,28,86,182
S8134,Paula Dirico,82,4,21,107
S8135,Bernice Swayzer,100,6,71,177
S8136,Nicholas Martin,21,36,28,85
S8137,Beverly Nunnally,68,80,44,192
S8138,William Ray,30,96,3,129
S8139,Katrina Robinson,98,13,16,127
S8140,Michele Khan,0,10,22,32
S8141,Marsha Mcclintic,87,14,29,130
S8142,Suzanne Breaud,7,67,61,135
S8143,Mia Bell,57,1,20,78
S8144,Jay Collins,72,79,6,157
S8145,Earl Page,45,91,72,208
S8146,Ethel Orourke,53,99,92,244
S8147,Gloria Galyen,33,77,31,141
S8148,Nicholas Dunn,86,21,29,136
S8149,William Stroupe,79,56,30,165
S8150,Geraldine Ramos,74,63,93,230
S8151,Christopher Jackson,69,3,42,114
S8152,Anette People,25,14,79,118
S8153,Berna Hardison,49,24,96,169
S8154,Michael Blackburn,30,90,67,187
S8155,John Carter,89,44,67,200
S8156,Howard Nguyen,68,9,6,83
S8157,Brian Perez,31,27,78,136
S8158,Emma Taylor,62,51,60,173
S8159,Wesley Singleton,98,55,86,239
S8160,Barry Tacker,89,4,68,161
S8161,Tanya Credi,94,24,63,181
S8162,Brad Rapelyea,5,93,50,148
S8163,Giovanni Flott,78,24,12,114
S8164,Debrah Tickle,11,46,51,108
S8165,Wilbur Morrison,39,29,50,118
S8166,Elliot Williams,70,77,93,240
S8167,Chanda Ferrel,16,15,49,80
S8168,Joellen Zamora,69,24,0,93
S8169,Charlotte Meredith,75,82,18,175
S8170,Mary Brown,98,69,52,219
S8171,Priscilla Moore,10,21,48,79
S8172,Walter Beauchamp,40,81,41,162
S8173,Alvin Hunt,46,86,62,194
S8174,Juan Hogan,78,63,0,141
S8175,Robert Malloy,77,81,28,186
S8176,Thomas Duncan,37,14,83,134
S8177,Crystal Howard,42,3,70,115
S8178,Kimberly Mullins,93,26,8,127
S8179,Rafael Gellings,74,97,96,267
S8180,Robert Kelly,64,77,7,148
S8181,Nancy Gover,25,40,91,156
S8182,David Wicker,18,45,5,68
S8183,Fern Colantro,40,12,80,132
S8184,Claude Cox,60,29,19,108
S8185,Rose Candland,15,57,35,107
S8186,Cristine Yang,37,14,70,121
S8187,Chad Draudt,73,78,46,197
S8188,Selina Muth,48,27,61,136
S8189,Ashley Davis,89,93,99,281
S8190,Melvin Hirth,94,36,83,213
S8191,Rachel Wall,1,59,54,114
S8192,Rose Villanueva,62,57,41,160
S8193,Tony Greer,48,94,12,154
S8194,Mark Larsen,52,29,12,93
S8195,James Blevins,42,42,59,143
S8196,Kevin Kassler,22,51,51,124
S8197,Bradley Mccarver,97,93,14,204
S8198,Pamela Lyle,69,58,35,162
S8199,Robert Rogers,15,9,56,80
S8200,Willie Floer,57,25,15,97
S8201,Susanna Patterson,31,60,49,140
S8202,Gertrude Wild,27,65,83,175
S8203,Susan Ramirez,86,67,63,216
S8204,Casey Cox,63,19,63,145
S8205,Brandon Mcmichael,86,5,40,131
S8206,Lana Underwood,48,90,54,192
S8207,Ramon Rogers,41,4,49,94
S8208,Nidia Lemons,28,46,61,135
S8209,Tracy Meacham,1,85,60,146
S8210,John Mccartney,73,61,21,155
S8211,Deborah Scott,23,57,55,135
S8212,Charles Marmol,73,94,21,188
S8213,Linda Grossman,99,73,88,260
S8214,Sherry Vincent,22,60,99,181
S8215,Lisa Haag,94,28,58,180
S8216,Geneva Bagaoisan,39,29,22,90
S8217,Douglas Rottinghaus,14,27,48,89
S8218,Essie Gonsalves,56,85,8,149
S8219,Felicita Miller,74,33,85,192
S8220,Terence Brown,1,98,37,136
S8221,Kristin Oelschlaeger,41,72,9,122
S8222,Timothy Smith,8,89,81,178
S8223,Mao Andrew,8,11,0,19
S8224,Ruth Hamel,91,80,95,266
S8225,Julie Calvo,90,15,17,122
S8226,Fred Leonhardt,9,5,55,69
S8227,Lily Choate,70,10,28,108
S8228,Laurel Steinert,11,20,35,66
S8229,Jose Wilson,1,44,34,79
S8230,John Rybicki,82,15,48,145
S8231,Carlo Greene,0,97,93,190
S8232,William Ragsdale,44,15,40,99
S8233,Vincent Fowler,85,46,36,167
S8234,George Dergance,11,51,7,69
S8235,Terri Parker,2,67,12,81
S8236,Amanda King,75,10,95,180
S8237,Leon Trujillo,47,7,62,116
S8238,Sylvia Orduno,3,13,6,22
S8239,James Dowell,89,41,17,147
S8240,Tabatha Smallwood,66,16,49,131
S8241,Dolores Vanhoutte,49,64,51,164
S8242,Eileen Page,72,69,69,210
S8243,Kathy Redenz,27,93,4,124
S8244,Ivory Weston,95,79,5,179
S8245,Daniel Orear,98,77,80,255
S8246,Barbara Harford,1,65,22,88
S8247,Dana Hogue,74,78,17,169
S8248,Nova Rice,31,16,18,65
S8249,Tracy Graddy,78,8,57,143
S8250,Jose Paradis,85,75,40,200
S8251,Adolfo Blackburn,26,15,100,141
S8252,Harold Haynes,30,50,25,105
S8253,Chris Cline,19,57,77,153
S8254,Maria Murphy,13,46,89,148
S8255,Arthur Driggers,8,42,56,106
S8256,Bessie Hershberger,62,89,40,191
S8257,Brandon Johnson,40,46,46,132
S8258,Melinda Luff,53,16,93,162
S8259,Nancy Rankin,48,71,63,182
S8260,Blanche Bryan,65,99,8,172
S8261,Alton Wood,24,10,36,70
S8262,Peter Wooten,6,36,37,79
S8263,Judy Sherry,9,32,83,124
S8264,Ruth King,21,85,37,143
S8265,Justin Caldwell,56,94,56,206
S8266,Ruth Robins,55,35,78,168
S8267,Brian Mcnorton,90,70,84,244
S8268,Thanh Bolen,64,57,27,148
S8269,Joseph Lewis,50,57,53,160
S8270,Claire Hayes,18,19,19,56
S8271,Kristie Upham,81,5,52,138
S8272,Andre Barnes,27,32,24,83
S8273,John Denny,83,68,94,245
S8274,Paul Waters,87,53,66,206
S8275,Richard Ballew,65,37,83,185
S8276,Larry Ragusano,83,32,28,143
S8277,Nelle Couch,43,19,21,83
S8278,Rodolfo French,11,77,2,90
S8279,Donald Parker,38,87,92,217
S8280,Jonathan Clark,68,70,86,224
S8281,Brandon Meyer,100,55,4,159
S8282,Laura Tate,47,74,26,147
S8283,Christopher Higginbotham,83,88,89,260
S8284,Doris Hledik,64,18,59,141
S8285,Steven Morgan,46,28,9,83
S8286,Ryan Ladner,25,76,69,170
S8287,Robert Delgado,67,4,29,100
S8288,George Rubio,67,34,8,109
S8289,Robert White,23,2,95,120
S8290,Andrew Timms,40,31,34,105
S8291,Linda Mcdonald,30,4,54,88
S8292,Arthur Putnam,99,5,29,133
S8293,Edith Arneecher,68,47,36,151
S8294,Horacio Havir,29,40,87,156
S8295,Tammy Everett,73,68,21,162
S8296,Karen Harris,50,69,100,219
S8297,George Romero,58,28,76,162
S8298,John Zanola,60,85,48,193
S8299,Mary Bisio,1,67,73,141
S8300,Beverly Blackburn,16,9,65,90
S8301,Lillie Miller,1,3,18,22
S8302,Christopher Olivares,30,99,6,135
S8303,Levi Tobar,95,43,56,194
S8304,Ernest Kerns,51,94,100,245
S8305,Walter Conklin,58,42,29,129
S8306,Anna Heath,4,23,7,34
S8307,Janet Jordon,16,81,42,139
S8308,Val Duda,26,58,72,156
S8309,Jasmine Jefferson,29,42,44,115
S8310,Nicholas Kull,63,41,63,167
S8311,Elvira Saunders,60,17,55,132
S8312,Joyce Perry,22,31,50,103
S8313,Rebecca Connors,80,79,91,250
S8314,Gail Barker,45,81,34,160
S8315,Sharon Corliss,55,90,26,171
S8316,Betty Albanese,62,21,15,98
S8317,Katherine Jones,30,4,41,75
S8318,Elizabeth Shutt,61,66,49,176
S8319,Rae Robertson,60,29,50,139
S8320,James Harding,20,47,16,83
S8321,Keith Kocon,90,97,2,189
S8322,Jennifer Trice,99,14,69,182
S8323,Harvey Connell,0,1,89,90
S8324,Nancy Spencer,51,29,87,167
S8325,Steven Myers,14,25,78,117
S8326,Lee Howard,6,54,65,125
S8327,Janet Pigford,78,33,29,140
S8328,Kisha Cashdollar,40,87,51,178
S8329,Tracy Hernandez,29,8,30,67
S8330,Jane Hall,45,100,53,198
S8331,Donna Sutton,77,46,43,166
S8332,Shannon Simone,22,54,22,98
S8333,Donald Charles,8,9,39,56
S8334,Juliette Perotti,39,84,4,127
S8335,Daniel Brown,29,29,12,70
S8336,Tracey Beasley,23,39,44,106
S8337,Joan Vaught,92,70,96,258
S8338,Steve Walker,94,90,93,277
S8339,Denis Franck,46,30,31,107
S8340,Margie Treider,49,43,29,121
S8341,Evelyn Nieto,36,90,88,214
S8342,Steven Hoelscher,57,12,62,131
S8343,Levi Stevenson,79,9,67,155
S8344,Johnnie Eledge,98,84,71,253
S8345,Chelsea Bove,20,6,46,72
S8346,Bethany Brown,70,55,94,219
S8347,Kenny King,42,77,29,148
S8348,Katheryn Brackett,0,90,84,174
S8349,Janice Warner,77,19,32,128
S8350,Veronica Hodge,0,96,61,157
S8351,Dorothy Rutherford,89,2,64,155
S8352,Rufus Clemmons,89,68,55,212
S8353,Anna Harris,1,15,76,92
S8354,Charles Stinson,36,83,13,132
S8355,George Bailey,37,5,84,126
S8356,Heather Chalker,88,21,13,122
S8357,Ann Nogle,8,76,18,102
S8358,Patty Marcum,62,32,49,143
S8359,Dale Smiley,59,37,51,147
S8360,Joseph Urban,7,72,27,106
S8361,Jaime James,24,28,2,54
S8362,Harry Robinson,76,40,63,179
S8363,Anthony Wheeler,99,67,18,184
S8364,Robin Brantner,1,96,56,153
S8365,Margaret Gilbert,98,14,7,119
S8366,Brenda Moore,54,5,26,85
S8367,Sebastian Delgado,27,54,93,174
S8368,Michael Gonzales,93,64,2,159
S8369,Joshua Thomas,45,63,27,135
S8370,Henrietta Summerlin,98,69,79,246
S8371,Anna Webber,93,49,50,192
S8372,Maria Reine,38,89,9,136
S8373,Donald Cornwell,6,32,73,111
S8374,Jose Hollis,59,46,54,159
S8375,Wilma Conrad,80,22,48,150
S8376,Ronald Franco,58,3,47,108
S8377,Mary Mifflin,92,78,89,259
S8378,Naomi West,18,7,45,70
S8379,Bonnie Mahabir,35,10,63,108
S8380,John Despres,72,26,84,182
S8381,Keith Jackson,78,99,96,273
S8382,Ian Kates,10,45,68,123
S8383,Katherine Cadet,21,94,17,132
S8384,David Delaune,7,28,55,90
S8385,Kenneth Avellino,60,12,12,84
S8386,Juanita Bean,15,78,49,142
S8387,Susan Maymi,10,46,6,62
S8388,Cecile Lewandowski,31,67,75,173
S8389,Shenita Cortez,34,82,98,214
S8390,Robert Lepak,21,100,50,171
S8391,Robert Siler,76,23,55,154
S8392,Bob Johnson,47,37,50,134
S8393,Floyd Phang,47,58,15,120
S8394,Fawn Doyle,97,71,2,170
S8395,Fred Marrara,53,6,34,93
S8396,Jerome Herman,52,1,36,89
S8397,Willie Perillo,13,59,94,166
S8398,Susan Nelson,75,37,84,196
S8399,Kathleen Phelan,70,85,41,196
S8400,Patricia Torres,5,2,41,48
S8401,Leon Samples,38,81,60,179
S8402,Sherry Mendoza,30,65,97,192
S8403,Jarvis Wright,93,79,77,249
S8404,Brian Brock,67,23,48,138
S8405,Teresa Bridges,15,30,56,101
S8406,John Sutton,90,9,22,121
S8407,Nicole Buchanan,48,87,57,192
S8408,Millicent Robinson,54,49,53,156
S8409,Patricia Osborne,61,62,10,133
S8410,Alexander White,50,60,70,180
S8411,Morris Brown,14,50,33,97
S8412,Michael Jasso,56,49,53,158
S8413,Polly Kuo,84,49,23,156
S8414,Victoria Flowe,6,66,9,81
S8415,Matthew Hamilton,53,65,78,196
S8416,Darnell Brent,12,94,7,113
S8417,Ralph Hartwell,90,92,32,214
S8418,Tamika Randall,95,87,87,269
S8419,Josefina Keshishian,36,48,30,114
S8420,William Oneal,21,36,26,83
S8421,Myra Stoner,40,85,12,137
S8422,Yanira Campbell,52,94,30,176
S8423,Kerry Fitch,72,18,35,125
S8424,Dannie Yanez,62,19,24,105
S8425,Lucas Smith,9,23,51,83
S8426,Stephanie Cranford,50,16,80,146
S8427,Heather Jones,0,43,54,97
S8428,Carol Schrader,66,19,23,108
S8429,Emogene Carmona,37,28,18,83
S8430,Brooke Cook,30,93,2,125
S8431,Gregory Higgins,6,91,76,173
S8432,Wanda Rice,50,11,43,104
S8433,Gary Bintner,66,14,83,163
S8434,George Trevino,79,26,55,160
S8435,Miguel Staples,45,42,86,173
S8436,Barbara Koch,39,20,37,96
S8437,Dorothy Barnes,43,68,44,155
S8438,Tyisha White,48,98,52,198
S8439,Erica Christenberry,20,73,68,161
S8440,Lea Lambert,33,50,83,166
S8441,Joseph Lanehart,10,76,61,147
S8442,Craig Mcclellan,47,75,52,174
S8443,David Neal,98,62,91,251
S8444,Kimberly Spohn,48,39,22,109
S8445,Leo Clontz,88,43,11,142
S8446,Bessie Browning,66,90,54,210
S8447,Krista Lebow,15,83,56,154
S8448,Billy Christianson,45,92,2,139
S8449,Rueben Waterson,86,51,12,149
S8450,Wendy Ramirez,35,62,42,139
S8451,Bryan Robinson,46,66,44,156
S8452,Mark Koonce,17,18,65,100
S8453,Rachel Traver,14,74,72,160
S8454,William Christin,73,48,32,153
S8455,Jennifer Mart,3,18,84,105
S8456,Barbara Sparling,35,62,21,118
S8457,Martin Mcatee,20,57,48,125
S8458,William Atkin,65,55,69,189
S8459,Maude Simpson,53,56,72,181
S8460,Sara Martinez,57,89,75,221
S8461,Stephen Brown,38,48,49,135
S8462,Joy Beasley,44,49,27,120
S8463,Nancy Wall,37,63,43,143
S8464,Jean Cain,94,31,51,176
S8465,Jannette Guertin,52,52,8,112
S8466,Patrick Nolin,33,62,58,153
S8467,Patsy Murguia,77,38,0,115
S8468,Steven Lancaster,27,71,28,126
S8469,Leonor Long,10,54,55,119
S8470,Raphael Simpkins,85,50,80,215
S8471,Vincent Jackson,88,25,64,177
S8472,Otto Valley,87,72,81,240
S8473,David Winkler,38,67,25,130
S8474,Lucille Pugmire,62,35,81,178
S8475,Michele Lairmore,15,45,97,157
S8476,Caroline Englert,43,88,88,219
S8477,Nancy Stewart,33,23,51,107
S8478,Scott Horn,9,5,90,104
S8479,Katie Boston,99,1,54,154
S8480,Leo Sanders,44,48,53,145
S8481,Mark Newland,73,9,15,97
S8482,Ada Ali,49,70,40,159
S8483,Kevin Boehm,68,11,41,120
S8484,Bernice Wheaton,18,42,47,107
S8485,Karen Johnson,60,47,28,135
S8486,Wilma Smith,64,63,2,129
S8487,Dorothy Desimone,20,57,89,166
S8488,Jose Garcia,54,36,91,181
S8489,Frances Hansing,78,20,40,138
S8490,Patricia Bernier,88,26,99,213
S8491,Moses Long,73,51,9,133
S8492,Angelica Sirmons,76,33,75,184
S8493,Peter Belanger,95,81,40,216
S8494,Marco Harryman,1,81,52,134
S8495,Aaron Suggs,48,52,25,125
S8496,Kevin Turner,97,10,37,144
S8497,Paul Gardner,42,30,47,119
S8498,Andrew Cabral,0,4,40,44
S8499,Alvera Ingalls,55,52,40,147
S8500,Hugh Sandoval,68,72,67,207
S8501,Annabelle Meyers,55,71,17,143
S8502,Clifford Nunez,10,22,48,80
S8503,Edward Efird,63,11,55,129
S8504,Joseph Braun,89,16,50,155
S8505,Irene Bronson,85,66,96,247
S8506,Edward Lewis,92,66,51,209
S8507,Elizabeth Hanson,83,49,91,223
S8508,Alicia Rich,3,34,89,126
S8509,James Miyata,59,13,5,77
S8510,Jeffrey Garcia,80,28,44,152
S8511,Suzanne Dupont,48,69,11,128
S8512,Cathy Milam,51,97,32,180
S8513,David Hardy,97,27,50,174
S8514,Yuette Odonnell,77,5,13,95
S8515,Michelle Carrera,26,76,61,163
S8516,Cindy King,58,59,71,188
S8517,Shawn Markovich,40,34,76,150
S8518,Cindy Spangler,75,91,62,228
S8519,Tiffany Shine,17,14,83,114
S8520,Timothy Frasure,55,49,24,128
S8521,Jeri Sheridan,46,14,12,72
S8522,Marian Shook,62,32,49,143
S8523,Kathy Crain,18,16,51,85
S8524,Janet Holbrook,87,67,81,235
S8525,Lloyd Acosta,47,81,87,215
S8526,Steven Eiben,79,87,19,185
S8527,Dena Mayberry,33,46,30,109
S8528,Kathy Scorgie,71,12,24,107
S8529,Bobby Foster,94,63,30,187
S8530,Jerry Arnold,60,14,23,97
S8531,James James,36,79,95,210
S8532,Adrian Parker,93,1,0,94
S8533,Charles Gordon,34,23,67,124
S8534,Carol Gorenberg,43,69,98,210
S8535,Jeff Threadgill,64,54,27,145
S8536,Clyde Enriquez,9,45,10,64
S8537,James Adams,23,35,58,116
S8538,John Barclay,17,64,25,106
S8539,Jacob Hill,97,62,43,202
S8540,Katie Pierro,50,83,70,203
S8541,Brian Johnson,74,32,6,112
S8542,Elmer Rainer,83,10,17,110
S8543,Roy Mcmaster,44,94,45,183
S8544,Diana Norwood,74,20,21,115
S8545,Marcia Tarlow,24,47,67,138
S8546,Christopher Hoy,97,64,43,204
S8547,Charles Douglas,2,90,66,158
S8548,Leonard Love,39,81,71,191
S8549,Michael Padberg,30,6,66,102
S8550,Joan Mcgill,34,73,14,121
S8551,Angel Page,2,89,59,150
S8552,Nannie Curreri,67,51,20,138
S8553,Deanna Warren,46,85,86,217
S8554,Ellen Angelo,17,76,21,114
S8555,Barbara Gibbs,100,3,43,146
S8556,Johnnie Avery,11,90,48,149
S8557,Gary Pittman,86,24,72,182
S8558,John Penwell,44,79,73,196
S8559,Steven Greene,74,53,69,196
S8560,Stephanie Gill,69,76,82,227
S8561,Curtis Hogan,54,88,49,191
S8562,Troy Swick,88,72,32,192
S8563,Catherine Moore,73,28,71,172
S8564,Rosie Bild,44,24,35,103
S8565,Gary Martin,39,3,40,82
S8566,Tim Hartt,18,16,91,125
S8567,Veronica Aguilar,85,44,69,198
S8568,Owen Prothro,85,41,25,151
S8569,Walter Warner,97,94,74,265
S8570,Loretta Mcmanus,79,4,38,121
S8571,Frances Valdez,9,58,50,117
S8572,Eric Owen,78,27,44,149
S8573,Brock Loveland,45,75,64,184
S8574,Alan Doherty,22,86,53,161
S8575,Hal Gross,19,88,28,135
S8576,Mark Wooton,59,48,72,179
S8577,Helen Morgan,47,100,51,198
S8578,Cindy Martin,62,79,27,168
S8579,Margaret Herauf,14,21,19,54
S8580,Linda Mercado,0,62,71,133
S8581,James Fleming,55,5,96,156
S8582,Basil Slaughter,54,75,73,202
S8583,Kathleen Gustafson,46,46,78,170
S8584,John Haynes,19,2,85,106
S8585,Theodore Towns,76,11,87,174
S8586,Julie Sanots,99,51,29,179
S8587,William Elman,35,68,47,150
S8588,Nancy Connors,17,60,21,98
S8589,Jeffrey Frausto,22,33,14,69
S8590,Shannon Hernandez,67,69,46,182
S8591,Lisa Perotti,27,71,15,113
S8592,Travis Woolfolk,28,84,11,123
S8593,Jannie Thompson,52,30,86,168
S8594,Harold Mandrell,72,54,20,146
S8595,Ann Scales,94,82,84,260
S8596,Maria Larcom,90,61,45,196
S8597,Belinda Johnson,66,84,62,212
S8598,Robert Small,25,13,96,134
S8599,Sherri Scott,90,98,74,262
S8600,Arthur Harrell,48,53,79,180
S8601,Leonard Hauger,47,25,34,106
S8602,Virginia Bradley,37,25,4,66
S8603,Debbie Cheng,83,5,83,171
S8604,Cinthia Collins,78,54,19,151
S8605,Elizabeth Dietzel,58,20,62,140
S8606,Clarice Mendoza,20,8,17,45
S8607,Tommie Mendoza,66,20,90,176
S8608,Joesph Mcintyre,20,83,22,125
S8609,Eda Caswell,52,99,45,196
S8610,Michael Curl,29,27,45,101
S8611,Nancy Groff,99,78,5,182
S8612,Betty Trojanowski,88,36,21,145
S8613,Andrea Bonnett,26,86,54,166
S8614,Sabrina Bell,72,11,57,140
S8615,David White,68,20,28,116
S8616,Mary Nail,80,34,29,143
S8617,Cecil Wilson,51,13,16,80
S8618,James Pace,6,51,17,74
S8619,Miles Crawford,28,92,52,172
S8620,Matthew Jageman,40,38,39,117
S8621,Brenda Eisentrout,72,71,32,175
S8622,Thomas Alonso,91,82,77,250
S8623,Katherine Nunez,38,84,82,204
S8624,Dave Louis,95,42,0,137
S8625,Ruth Baker,14,32,37,83
S8626,George Swenson,99,49,79,227
S8627,Dorothy Holmes,34,17,75,126
S8628,Mary Morgan,25,18,40,83
S8629,Ernest Cook,21,60,40,121
S8630,Genevieve Hollingsworth,71,85,89,245
S8631,Novella Fletcher,69,80,6,155
S8632,Mildred Hines,91,87,67,245
S8633,Gerald Jones,66,18,7,91
S8634,Stanton Pepin,71,43,87,201
S8635,Alvin Mcmilliam,17,69,42,128
S8636,Salvador Morgan,86,19,91,196
S8637,Glenn Halvorson,24,59,15,98
S8638,Carol Sanchez,14,61,64,139
S8639,Erin Riley,99,13,27,139
S8640,Shannon Maisonave,14,54,21,89
S8641,Michael Linquist,35,85,81,201
S8642,Clyde Wallace,71,96,8,175
S8643,Bethany Fetter,97,62,44,203
S8644,Raymond Wilkerson,41,52,60,153
S8645,Kenneth Axel,95,100,84,279
S8646,Steven Bordley,86,90,31,207
S8647,Christian Rosa,67,28,64,159
S8648,Gerald Correia,48,88,63,199
S8649,Reginald Moffett,32,73,83,188
S8650,Emil Barkley,84,80,64,228
S8651,Lucia Taylor,39,77,22,138
S8652,Mary Ball,66,85,72,223
S8653,Rodney Riley,29,41,31,101
S8654,Terri Azevedo,44,62,33,139
S8655,Andrew Danker,54,72,32,158
S8656,Gary Webb,59,78,92,229
S8657,Carmen Teeter,69,68,33,170
S8658,Regina Powers,6,17,8,31
S8659,Leo Martin,22,54,54,130
S8660,Danielle Dias,22,6,57,85
S8661,Jeffrey Finneran,3,81,75,159
S8662,Peggy Brown,7,89,70,166
S8663,Rosemarie Maedche,32,31,80,143
S8664,Barbara Brothern,70,79,79,228
S8665,Helen Brinegar,66,45,50,161
S8666,Timothy Brickman,47,68,37,152
S8667,Maudie Overman,26,78,21,125
S8668,William Lyons,35,95,90,220
S8669,Thomas Carrothers,33,38,93,164
S8670,Eugene Lee,98,18,80,196
S8671,Marilou Watkins,71,67,68,206
S8672,Jerry Miller,78,72,85,235
S8673,Mary Turner,27,47,93,167
S8674,Laurence Clemons,20,19,53,92
S8675,Janet Johnson,86,1,81,168
S8676,Gary Underwood,70,28,53,151
S8677,Margaret Thieman,70,53,90,213
S8678,Bennett Plymel,64,0,8,72
S8679,Dwight Shockley,3,4,19,26
S8680,David Kittelson,59,18,42,119
S8681,Adrienne Spurlock,94,90,10,194
S8682,Michael Stilwell,53,99,86,238
S8683,Michelle Swain,50,28,55,133
S8684,Carol Hill,53,21,27,101
S8685,Lucy Griffith,36,19,62,117
S8686,Robert Walsh,1,23,29,53
S8687,Marion Tauras,44,70,23,137
S8688,Robert Garrison,71,56,98,225
S8689,Kathleen Leal,16,28,62,106
S8690,Marjorie Mendoza,87,56,85,228
S8691,Bobbie Halvorsen,79,31,96,206
S8692,Rena Elliott,86,12,3,101
S8693,Josie Dugue,3,11,29,43
S8694,Brian Martinez,68,41,99,208
S8695,Janice Oliver,19,92,44,155
S8696,Susan Fairley,6,14,90,110
S8697,Mark Younger,83,97,36,216
S8698,Brian Battle,82,47,78,207
S8699,Jim Malinowski,81,65,30,176
S8700,Grant Harris,84,1,39,124
S8701,Willian Collins,15,44,50,109
S8702,Dolores Moreno,58,99,75,232
S8703,Jeff Booth,28,88,63,179
S8704,Rayna Bishop,71,44,38,153
S8705,Mary Davison,42,73,99,214
S8706,Russell Gibbs,10,35,61,106
S8707,Jackie Pearson,91,79,81,251
S8708,George Roark,85,73,20,178
S8709,Elizabeth Stephens,50,72,15,137
S8710,Derrick Roman,48,79,78,205
S8711,David Morales,67,63,73,203
S8712,David Barnes,69,25,95,189
S8713,Lucille Null,53,70,13,136
S8714,Muriel Yang,68,33,9,110
S8715,James Chambers,54,44,11,109
S8716,Dana Garcia,64,13,50,127
S8717,Troy Ruckman,38,93,93,224
S8718,Bradley Cole,69,87,76,232
S8719,Troy Brown,33,6,86,125
S8720,Luis Kamp,59,29,82,170
S8721,Colleen Hoover,62,6,90,158
S8722,William Hamil,95,12,6,113
S8723,Willie Sharkey,23,64,83,170
S8724,Louise Perng,5,89,86,180
S8725,Bonnie Miller,37,61,73,171
S8726,Bryan Dion,63,69,34,166
S8727,Bradley Bradshaw,36,70,0,106
S8728,Robert Joy,30,72,68,170
S8729,Tana Strouse,66,1,52,119
S8730,Kristin Lamb,2,3,51,56
S8731,Arthur Cahal,33,81,52,166
S8732,Sandra Hansen,55,18,34,107
S8733,Susan Strang,27,76,8,111
S8734,Fred Simpson,91,84,86,261
S8735,Elizabeth Moore,14,9,56,79
S8736,Cheryl Scott,13,38,91,142
S8737,Geraldine Scurry,53,9,79,141
S8738,Theodore Paulseth,12,83,15,110
S8739,Harriett Wall,10,96,81,187
S8740,Joan Ford,80,94,22,196
S8741,Louis Evans,85,37,23,145
S8742,Joey Day,92,49,16,157
S8743,Robert Moffett,79,10,95,184
S8744,Margaret Metz,0,41,46,87
S8745,Christina Markert,15,82,22,119
S8746,William Kirkpatrick,61,49,57,167
S8747,Jane Baldwin,27,57,56,140
S8748,Patricia Cho,11,72,14,97
S8749,Peter Sampson,28,69,45,142
S8750,Edward Phillips,65,6,76,147
S8751,Steve Gregory,38,43,13,94
S8752,James Sebeniecher,98,53,33,184
S8753,Linda Watson,53,92,57,202
S8754,Lillian Gavenda,87,78,16,181
S8755,Martin Quay,96,39,63,198
S8756,Martin Darden,71,83,69,223
S8757,Maria Samantha,47,83,71,201
S8758,Gladys Harvey,74,13,71,158
S8759,Jami Dougal,71,55,39,165
S8760,Joshua Portsche,50,53,39,142
S8761,Iliana Wheat,15,49,71,135
S8762,George Harrison,21,45,10,76
S8763,Laura Mcelveen,76,47,38,161
S8764,Ellen Ruiz,2,96,100,198
S8765,Sharon Lefebvre,75,76,75,226
S8766,Mari Arrington,46,92,46,184
S8767,David Poque,27,37,85,149
S8768,Louis Lawrence,86,0,22,108
S8769,Benedict Jackson,77,66,13,156
S8770,Craig Johnson,17,43,88,148
S8771,Brian Blackman,44,88,33,165
S8772,Linda Carroll,93,79,96,268
S8773,Susan Torres,25,72,95,192
S8774,Dacia Corona,65,82,20,167
S8775,Mary Young,92,23,61,176
S8776,Pat Pikes,8,51,9,68
S8777,Carlton Mcculley,5,16,18,39
S8778,Bradley Martinez,94,3,3,100
S8779,William Louviere,80,72,10,162
S8780,Robert Butler,34,49,66,149
S8781,Robert Olvera,60,73,0,133
S8782,Sean Boyd,13,87,85,185
S8783,Thelma Blakeslee,88,65,44,197
S8784,Patricia Berger,33,13,68,114
S8785,Steve Jones,95,85,90,270
S8786,Millie Quinlivan,5,4,43,52
S8787,David Boyd,27,97,63,187
S8788,Barbara Stoffregen,61,15,47,123
S8789,Carol Martinez,91,90,41,222
S8790,Walter Carrell,52,100,98,250
S8791,Charles Porter,51,22,35,108
S8792,Eric Boone,11,63,82,156
S8793,Bernard Davis,55,50,80,185
S8794,Brandon Myers,97,1,35,133
S8795,Merlin Cooper,74,45,70,189
S8796,Grover Pilon,31,42,80,153
S8797,Pamela Farley,35,2,11,48
S8798,Tricia Tribble,2,39,20,61
S8799,James Thompson,30,58,23,111
S8800,Dianne Miller,47,90,52,189
S8801,Wilmer Gore,16,9,39,64
S8802,Michael Wendel,81,4,41,126
S8803,Gilbert Crossland,48,69,13,130
S8804,Brittany Norman,30,92,20,142
S8805,Jonathan Smith,28,70,36,134
S8806,Frances Taylor,45,74,50,169
S8807,Joseph Howell,20,9,36,65
S8808,James Ruth,60,57,8,125
S8809,Patricia Bennett,94,92,83,269
S8810,Deborah Wade,99,92,65,256
S8811,Theresa Ciocca,61,45,80,186
S8812,Irene West,22,8,66,96
S8813,Donna Friday,46,89,93,228
S8814,Rosa Rocco,37,79,97,213
S8815,Robin Ervin,81,94,54,229
S8816,Jacqueline Maine,37,70,46,153
S8817,Wilson Sayler,65,97,98,260
S8818,Terri Parrish,96,47,81,224
S8819,Patrick Escobar,59,78,15,152
S8820,Shaun Bessick,95,20,87,202
S8821,Tim Abreu,88,12,16,116
S8822,Kathryn Harris,71,78,55,204
S8823,Gladys Heep,64,74,98,236
S8824,Claude Leonard,10,43,79,132
S8825,Maria Mclin,100,62,49,211
S8826,Joseph Stewart,8,58,14,80
S8827,Kenneth Nicholas,96,30,95,221
S8828,Michael Yeargin,92,44,35,171
S8829,Wilbert Aviles,5,48,88,141
S8830,Benjamin Bogle,57,65,47,169
S8831,Nancy Bumbrey,42,34,22,98
S8832,Walter Styer,48,44,99,191
S8833,James Mitchell,1,7,15,23
S8834,Donald Kenner,38,81,32,151
S8835,Elaine Saucedo,92,77,62,231
S8836,Vera Sibley,75,29,67,171
S8837,Edward Willis,36,4,82,122
S8838,Cody Johnson,14,32,6,52
S8839,Henrietta Bowie,49,28,79,156
S8840,Diana David,97,8,68,173
S8841,Marjorie Grimes,18,90,79,187
S8842,Alberto Bartels,49,60,47,156
S8843,Terrence Huber,9,13,96,118
S8844,Bobby Mccord,52,85,0,137
S8845,Jason Sanders,29,100,31,160
S8846,Dorothy Lusk,10,23,35,68
S8847,Patricia Dutton,39,35,79,153
S8848,Sadie Thomas,7,88,86,181
S8849,Annette Gonzalez,54,28,81,163
S8850,Karyn Goff,51,56,81,188
S8851,Robert Whyms,25,87,18,130
S8852,Elvia Harris,86,36,65,187
S8853,Albert Horton,57,48,3,108
S8854,Brenda Francis,12,96,66,174
S8855,Terry Mann,17,33,70,120
S8856,Kevin Smith,8,22,100,130
S8857,Peter Mcleland,40,71,58,169
S8858,Roy Fenske,97,25,82,204
S8859,Derrick Correa,39,66,71,176
S8860,Kelly Taylor,70,63,0,133
S8861,Maria Hershenson,27,84,6,117
S8862,Aaron Doman,32,25,0,57
S8863,Frederick Sulla,20,8,36,64
S8864,William Smith,75,64,8,147
S8865,Janay Brown,1,53,23,77
S8866,Erik Dalton,92,59,35,186
S8867,Kristen Ross,85,82,14,181
S8868,Michael Moore,85,72,26,183
S8869,Viviana Gum,57,54,94,205
S8870,Victor Blair,84,27,14,125
S8871,Randall Terrance,33,50,69,152
S8872,Armando Johnson,18,84,79,181
S8873,Lilliam Jackson,9,81,13,103
S8874,Tom Lewis,12,85,78,175
S8875,Vicki Moreno,85,13,79,177
S8876,Kristen Green,56,23,18,97
S8877,Roy Kim,82,16,44,142
S8878,Patricia Kovacs,51,88,87,226
S8879,Ann Oh,30,3,95,128
S8880,Christian Greer,22,83,64,169
S8881,Thomas Edminster,55,76,70,201
S8882,John Plante,46,48,98,192
S8883,Ruth Barden,4,49,73,126
S8884,Leslie Jenkins,43,75,96,214
S8885,Sheila Yang,100,19,41,160
S8886,Fran King,93,27,72,192
S8887,Rodney Chamberlain,71,76,84,231
S8888,Santos Webb,91,72,12,175
S8889,Doris Bartholomew,30,93,60,183
S8890,Erin Meredith,47,45,67,159
S8891,Cameron Lemoine,20,1,77,98
S8892,Antoine Fuller,56,15,61,132
S8893,Martin Gentry,45,100,64,209
S8894,Debbie Cianciola,21,17,62,100
S8895,Michael Brown,68,61,12,141
S8896,Yong Aubin,4,29,59,92
S8897,Dora Baskerville,37,33,56,126
S8898,Anthony Rempe,7,92,18,117
S8899,Adam Fincher,52,88,98,238
S8900,Misty Eagen,51,59,47,157
S8901,Robin Pond,40,24,3,67
S8902,John Alexander,60,93,96,249
S8903,Barbara Smith,57,43,73,173
S8904,Adam Wise,78,95,71,244
S8905,Michael Nguyen,80,18,93,191
S8906,Jon Duane,25,39,4,68
S8907,Effie Orahood,25,44,23,92
S8908,Sarah Schmidt,86,96,63,245
S8909,Ethel Kroll,74,91,3,168
S8910,Larry Brotherton,51,83,43,177
S8911,Olga Warnack,49,75,62,186
S8912,Elizabeth Hurt,14,81,37,132
S8913,Bernard Blankenship,33,11,70,114
S8914,Scott Cooper,22,29,9,60
S8915,Leticia Dobbins,24,55,19,98
S8916,John Kavanagh,5,36,88,129
S8917,Maurine Valentine,90,98,27,215
S8918,Katrina Freeze,0,19,28,47
S8919,Bonita Young,80,59,87,226
S8920,Eva Martin,28,67,66,161
S8921,Steve Sanchez,4,74,43,121
S8922,Monique Tanksley,3,61,72,136
S8923,Juanita Mcdonough,31,12,57,100
S8924,Margaret Escobedo,61,76,96,233
S8925,Sara Sanchez,72,79,44,195
S8926,Richard Brown,28,30,89,147
S8927,Elisa Kowal,26,94,7,127
S8928,Yolanda Stone,95,30,8,133
S8929,John Mcdonough,39,98,19,156
S8930,Amy Painter,37,30,53,120
S8931,Ruth Campbell,2,49,24,75
S8932,Jennifer Dillard,41,7,9,57
S8933,Susan Mcnair,12,100,1,113
S8934,Wayne Henderson,70,35,16,121
S8935,Manuel Stracke,45,9,34,88
S8936,Brenda Babb,53,48,49,150
S8937,Violet Dohse,13,87,27,127
S8938,Catherine Mckinney,7,88,83,178
S8939,Marilyn Metzger,19,24,78,121
S8940,Pedro Debem,93,80,40,213
S8941,Harry Childers,83,21,8,112
S8942,Claudia Tate,5,76,99,180
S8943,Scott Gagnon,54,49,14,117
S8944,Beth Miller,90,13,43,146
S8945,Chad Garner,48,30,18,96
S8946,Jay Hernandez,79,91,100,270
S8947,Helen Bass,92,47,71,210
S8948,Tom Obiesie,82,1,5,88
S8949,Michael Hernandez,94,24,52,170
S8950,Steve King,24,82,62,168
S8951,Robert Roman,66,86,93,245
S8952,Ursula Cloud,13,46,16,75
S8953,Steven Dorich,3,15,63,81
S8954,Juan Sweigart,47,1,51,99
S8955,Chrystal Zecca,74,10,18,102
S8956,Nancy Stevenson,48,86,17,151
S8957,Pamela Hayslip,69,51,14,134
S8958,Johnnie Johnson,44,15,5,64
S8959,Jerry Sipes,70,27,71,168
S8960,Sonja Smith,64,72,56,192
S8961,Patricia Richards,64,52,94,210
S8962,Marjorie Jacquemin,53,27,88,168
S8963,Mark Young,73,12,68,153
S8964,Steven Latimer,43,67,86,196
S8965,Michael Alcala,77,71,31,179
S8966,Lillian Freyermuth,62,67,75,204
S8967,Lora Currie,92,8,63,163
S8968,Kelly Leppert,8,34,40,82
S8969,Charles Bobbitt,97,80,73,250
S8970,Calvin Byun,54,32,70,156
S8971,Jonathan Wilson,78,66,11,155
S8972,Irma Fulton,87,7,53,147
S8973,Latoya Plessinger,19,15,90,124
S8974,Nicole Hudson,67,44,43,154
S8975,Lottie Mckennon,74,89,87,250
S8976,Keith White,50,52,44,146
S8977,Maggie Odell,79,79,61,219
S8978,Justin Fernberg,59,82,28,169
S8979,Raymond Cole,73,74,84,231
S8980,Gerard Covert,32,65,60,157
S8981,Elizabeth Hess,1,68,61,130
S8982,Lucas Mcmanus,40,4,5,49
S8983,Emily Robbins,78,0,96,174
S8984,Aileen Gutkowski,11,42,70,123
S8985,Robert Robison,88,88,41,217
S8986,Ed Charles,38,38,83,159
S8987,Thomas Guastella,5,18,95,118
S8988,James Nuzback,88,48,49,185
S8989,Shirley Taegel,58,70,58,186
S8990,Cornelius Lerner,75,35,33,143
S8991,Alex Kleffman,23,85,13,121
S8992,Arlene Padilla,52,71,97,220
S8993,Colleen Latour,28,71,4,103
S8994,James Hill,53,2,63,118
S8995,Shawn Mcintosh,86,48,46,180
S8996,Jennifer Santiago,18,8,28,54
S8997,Barbara Parker,17,11,71,99
S8998,Twana Michael,30,26,27,83
S8999,Angie Macmillan,62,87,86,235
S9000,Hazel Hernandez,90,16,65,171
S9001,Debra Brenna,93,99,44,236
S9002,Laura Bouton,79,33,98,210
S9003,Yolanda Burke,22,51,8,81
S9004,James Crout,59,97,0,156
S9005,Robin Miner,94,5,28,127
S9006,Gary Dunham,7,8,70,85
S9007,Lauren Vick,38,92,55,185
S9008,Ruby Tyler,76,51,39,166
S9009,Bessie Randall,75,67,23,165
S9010,Albert Fabry,71,19,58,148
S9011,Anna Harris,74,44,40,158
S9012,Anna Bucher,30,84,53,167
S9013,Douglas Fields,78,100,50,228
S9014,Charles Davidson,40,62,8,110
S9015,Naomi Brummell,50,9,41,100
S9016,Jose Gonzales,16,16,37,69
S9017,Mary Grant,42,87,23,152
S9018,Roy Blake,69,64,66,199
S9019,Eunice Lenton,66,34,94,194
S9020,Carrie Richey,56,92,32,180
S9021,Elizabeth Cavazos,52,96,56,204
S9022,Kendra Sikorski,24,48,58,130
S9023,Daniel Morter,19,91,45,155
S9024,Shawn Johnson,34,13,47,94
S9025,David Samuels,76,95,5,176
S9026,Manuel Garza,27,96,95,218
S9027,Rebecca Miller,20,94,94,208
S9028,Melissa Grober,91,67,47,205
S9029,Anneliese Elliott,28,1,56,85
S9030,Reginald Weiss,49,21,25,95
S9031,Elizabeth Reed,56,77,98,231
S9032,Charles Evans,97,9,61,167
S9033,Miranda Woodring,36,8,72,116
S9034,Barbara Dickson,5,85,4,94
S9035,Rosie Bailey,49,59,98,206
S9036,Merrilee Cook,35,54,0,89
S9037,Cynthia Young,30,2,100,132
S9038,Evelyn Worthy,26,90,17,133
S9039,Jason Hopkins,60,42,88,190
S9040,David Mckeane,93,90,0,183
S9041,Amy Ward,34,92,70,196
S9042,Christopher Perry,29,40,21,90
S9043,Casandra Davis,79,48,90,217
S9044,Sandee Carter,32,45,11,88
S9045,Katie Sindorf,49,31,51,131
S9046,Amie Williams,30,60,84,174
S9047,George Moore,70,47,87,204
S9048,Lisa Hansen,34,88,10,132
S9049,Jason Koonce,87,18,43,148
S9050,Chris Mcguire,42,79,99,220
S9051,Samuel Moore,51,70,77,198
S9052,Mark Benson,90,47,4,141
S9053,Sarah Dodge,7,36,67,110
S9054,Tierra Carroll,19,39,59,117
S9055,Jennifer Stillson,62,95,82,239
S9056,Betty Hurst,87,59,12,158
S9057,George Opie,15,8,51,74
S9058,Ronald Ingram,27,40,61,128
S9059,Tom Kenny,97,7,64,168
S9060,Henry Foos,39,61,42,142
S9061,Tiana Hinton,14,59,78,151
S9062,Sara Wheeler,57,41,71,169
S9063,Mark Higgins,37,62,75,174
S9064,Brandon Inman,100,94,0,194
S9065,Leonard Brown,63,78,91,232
S9066,Alton Roos,1,25,28,54
S9067,Antionette Adams,26,40,1,67
S9068,Aliza Groce,78,55,98,231
S9069,Amy Reynolds,87,68,48,203
S9070,Charles Smith,13,34,21,68
S9071,Anna Ward,37,52,37,126
S9072,Christy Gebhard,27,78,50,155
S9073,Leo Fernandez,44,71,33,148
S9074,Alan Mcafee,88,33,4,125
S9075,Luis Zimmerman,74,57,79,210
S9076,Jaime Walker,46,79,0,125
S9077,Larry Allen,23,54,10,87
S9078,Jesse Bradshaw,50,54,54,158
S9079,Irene Sharrar,46,24,62,132
S9080,Emmy Ward,42,21,73,136
S9081,Kenneth Sammartino,90,84,55,229
S9082,Benjamin Evans,32,99,65,196
S9083,Betty Stewart,62,92,58,212
S9084,Lee Mcclelland,89,59,87,235
S9085,Robert Fasciano,12,64,38,114
S9086,Kendra Garcia,13,97,32,142
S9087,Michael Gifford,64,97,3,164
S9088,Debra Morrison,26,66,83,175
S9089,Shannon Moore,4,19,29,52
S9090,Guadalupe Maddox,47,47,97,191
S9091,Ronald Burney,58,26,36,120
S9092,Rebecca Stark,16,80,34,130
S9093,Rose Giordano,49,58,96,203
S9094,Kathryn Nein,89,21,21,131
S9095,Loretta Lafontaine,50,66,2,118
S9096,Lester Lopez,42,5,85,132
S9097,Jaquelyn Babonis,54,11,6,71
S9098,Charles Chouinard,28,88,18,134
S9099,Melvin Zurasky,14,56,51,121
S9100,Lonnie Schwartz,94,89,74,257
S9101,Steven Barnett,99,73,2,174
S9102,Raymond Valdez,71,71,91,233
S9103,Harrison Perkins,94,97,81,272
S9104,Samuel Roden,74,59,91,224
S9105,George Kecskes,13,72,61,146
S9106,Neil Orozco,70,26,90,186
S9107,Cheryl Johnson,15,77,90,182
S9108,Roland Pucci,23,22,19,64
S9109,Stephanie Badami,20,100,4,124
S9110,Henry Skinner,8,54,44,106
S9111,Francis Cruz,69,60,40,169
S9112,Daniel Jackson,87,46,6,139
S9113,William Morrow,5,32,16,53
S9114,Donna Battle,69,54,35,158
S9115,Rosalyn Heath,94,69,7,170
S9116,Carmela Johnson,7,29,76,112
S9117,Bobbie Foesch,89,88,95,272
S9118,Stanley Guidry,46,77,34,157
S9119,Sara Avina,73,23,27,123
S9120,Arvilla Komula,35,88,38,161
S9121,Agnes Lindeland,88,87,12,187
S9122,Elizabeth Ripka,82,85,90,257
S9123,Crystal Kelley,89,69,38,196
S9124,Kara Dias,56,95,6,157
S9125,Roscoe Smith,24,46,23,93
S9126,Kalyn Davis,73,10,90,173
S9127,Travis Branco,32,86,11,129
S9128,Peter Lisonbee,10,10,12,32
S9129,Patrick Painter,5,75,13,93
S9130,Calvin Roberts,16,43,93,152
S9131,Laura Chastain,53,61,37,151
S9132,Patricia Kissell,100,69,68,237
S9133,Riley Sullivan,25,76,0,101
S9134,Norman Castle,0,13,98,111
S9135,Alice Collins,62,23,53,138
S9136,Michelle Miller,34,59,46,139
S9137,Ivy Schwartz,20,43,88,151
S9138,George Vick,43,45,58,146
S9139,Patricia Grimaldo,99,37,83,219
S9140,Emilio Harris,5,61,48,114
S9141,Joseph Cullison,8,28,0,36
S9142,Paul Neely,36,57,13,106
S9143,Wendi Kubik,94,95,85,274
S9144,Sean Vera,5,56,23,84
S9145,Peggy Tramel,65,9,86,160
S9146,Amanda Gumina,13,93,82,188
S9147,Rose Clemente,12,67,97,176
S9148,Edna Greer,12,4,60,76
S9149,Eva Salomone,16,7,52,75
S9150,Patricia Ingram,4,87,38,129
S9151,Sally Kohn,63,56,75,194
S9152,Suzanne Sacchetti,99,18,4,121
S9153,Joshua Powers,1,98,82,181
S9154,Teresa Hamilton,97,76,12,185
S9155,Cynthia Boutwell,35,44,15,94
S9156,Lana Forbes,50,58,68,176
S9157,Leslie Holliday,38,48,57,143
S9158,Rex Kath,63,41,93,197
S9159,Jack Gregory,17,61,40,118
S9160,John Deschamps,34,69,4,107
S9161,Odell Butler,42,84,63,189
S9162,Luz Radloff,38,33,9,80
S9163,Charles Kong,84,99,0,183
S9164,Steve Gaunce,91,84,62,237
S9165,David Griffin,12,17,75,104
S9166,Susan Abreu,16,69,24,109
S9167,Sean Duponte,79,52,69,200
S9168,Dorothea Keil,19,58,8,85
S9169,Marty Grubbs,71,10,68,149
S9170,Carmen Mathison,96,10,50,156
S9171,Jeannette Jordan,6,90,69,165
S9172,Joseph Galloway,20,73,74,167
S9173,Henry Rath,0,12,54,66
S9174,Lorenzo Lamson,21,50,65,136
S9175,John Moreland,88,13,34,135
S9176,Donald Auger,19,56,88,163
S9177,Jessica Self,26,72,29,127
S9178,Marie Powers,16,20,22,58
S9179,Gerardo Richardson,23,0,39,62
S9180,Heather Hartigan,87,34,27,148
S9181,Laurie England,64,18,89,171
S9182,Martha Rodriguez,100,24,56,180
S9183,Linda Modrak,87,85,95,267
S9184,Kenneth Rojas,10,67,35,112
S9185,Cole Seawright,40,57,40,137
S9186,Sergio Hicks,45,48,17,110
S9187,Lydia Valladares,86,61,96,243
S9188,James Mcdowell,32,31,64,127
S9189,Brandon Bryant,77,64,79,220
S9190,Toni Adams,5,3,28,36
S9191,Keely Wass,96,65,40,201
S9192,Robert Bishop,39,53,72,164
S9193,Victor Selvidge,73,11,81,165
S9194,Tianna Lamey,37,51,59,147
S9195,Ricardo Cohen,44,7,8,59
S9196,Mark Pittman,70,23,96,189
S9197,Craig Lewis,94,5,97,196
S9198,Jessica Trinka,9,14,66,89
S9199,Alejandro Johns,16,82,15,113
S9200,Coleen Leray,64,0,28,92
S9201,Mary Bradly,92,27,37,156
S9202,Amber Tillman,49,54,42,145
S9203,Stephen George,81,85,40,206
S9204,Randy Shirley,63,46,3,112
S9205,Agnes Mccarrel,49,80,69,198
S9206,Jodie Toher,49,34,38,121
S9207,Nathan Staley,23,61,75,159
S9208,Wayne Bruns,25,50,25,100
S9209,Ann Dean,83,39,92,214
S9210,Robert Kirk,83,75,24,182
S9211,Nancy Morgan,83,46,31,160
S9212,Ronnie Hernandez,15,90,99,204
S9213,Jimmie Gassaway,7,42,18,67
S9214,Frances Richards,30,33,94,157
S9215,Garland Wolfertz,66,35,75,176
S9216,Hattie Hollingsworth,26,57,44,127
S9217,Jessie Tramble,40,69,90,199
S9218,Scott Mumford,42,85,50,177
S9219,Juanita Ramirez,71,10,12,93
S9220,Robin Garo,68,91,62,221
S9221,Thomas Wood,83,62,9,154
S9222,Kevin Womack,5,23,89,117
S9223,Enrique Mcarthur,4,24,58,86
S9224,Will Vandyke,72,90,67,229
S9225,Michael Reyes,5,24,7,36
S9226,George Ranck,45,33,26,104
S9227,Susan Mcglone,0,92,42,134
S9228,Doris Omura,76,65,75,216
S9229,Robert Reardon,37,98,64,199
S9230,Ricky Vasquez,36,47,76,159
S9231,Frank Hornung,98,19,5,122
S9232,Samantha Holder,1,13,37,51
S9233,Jody Douglas,62,67,87,216
S9234,Geraldine Mcintyre,30,35,71,136
S9235,Janelle Pittman,95,87,10,192
S9236,Emily Tant,35,39,23,97
S9237,Barry Stone,22,10,19,51
S9238,Alexis Webb,68,56,73,197
S9239,Mae Bucio,91,36,5,132
S9240,Roy Justice,36,30,27,93
S9241,Valerie Volkman,76,67,66,209
S9242,Richard Smith,12,2,58,72
S9243,Peggy Mott,92,42,11,145
S9244,Nancy Bryant,8,3,28,39
S9245,Cyrus Smith,12,79,54,145
S9246,Billy Jankowiak,6,26,100,132
S9247,Sarah Ayers,50,46,20,116
S9248,Christina Sanders,1,74,15,90
S9249,Lola Turner,50,26,15,91
S9250,Leo Brugman,0,6,100,106
S9251,Martha Mitchell,72,17,2,91
S9252,Concha Rhymes,94,14,39,147
S9253,Margaret Rodgers,13,83,36,132
S9254,Edward Graham,76,20,56,152
S9255,Kevin Bosch,41,70,68,179
S9256,Mattie Jeffery,51,7,43,101
S9257,Ray Diaz,83,21,38,142
S9258,Terry Howland,54,42,70,166
S9259,Kimberly Seymour,23,78,41,142
S9260,James Beck,65,96,85,246
S9261,Joseph Perretta,28,11,1,40
S9262,Chelsea Woodcock,37,95,86,218
S9263,Shannon Snyder,79,48,1,128
S9264,David Bryant,95,38,58,191
S9265,Benjamin Shieh,82,31,5,118
S9266,Donald Washburn,91,5,33,129
S9267,Christina Browning,87,34,89,210
S9268,Tamala Mcdonald,64,27,100,191
S9269,Paul Mcanally,88,98,65,251
S9270,Barbara Stovall,41,60,72,173
S9271,Darwin Bordelon,3,48,24,75
S9272,Martha Eugene,17,30,34,81
S9273,Kenneth Jones,61,98,41,200
S9274,Diana Rago,45,3,19,67
S9275,Alex Jones,79,88,12,179
S9276,Clyde Jarvis,73,64,95,232
S9277,Mohammad Allen,25,56,24,105
S9278,Eleanora King,41,92,13,146
S9279,Robert Sanchez,36,83,39,158
S9280,Jean Lay,60,47,48,155
S9281,Travis Groover,78,6,50,134
S9282,Lawrence Ferkovich,15,98,9,122
S9283,Jamie Howard,65,0,66,131
S9284,Brian Depuy,91,49,32,172
S9285,Wade Smith,43,75,41,159
S9286,Richard Weaver,22,54,95,171
S9287,Theodore Paige,48,12,36,96
S9288,Angela Ashmore,57,8,8,73
S9289,Ella Mullett,82,1,44,127
S9290,Jesus Mccreedy,77,70,99,246
S9291,Trisha Hudson,35,81,37,153
S9292,Micheal Williams,41,73,71,185
S9293,Eddie Dougherty,27,20,72,119
S9294,Kasey Christian,88,82,29,199
S9295,Ruth Chiquito,10,72,44,126
S9296,Harry Hobart,34,80,14,128
S9297,Edward Harrison,36,56,5,97
S9298,Richard Caldwell,88,83,14,185
S9299,Jean James,77,83,91,251
S9300,Michael Huff,43,10,63,116
S9301,Thomas Chapin,39,91,19,149
S9302,Michael Baxley,49,58,63,170
S9303,Claire Willingham,100,73,29,202
S9304,Ronald Perez,68,41,53,162
S9305,Justin Clark,91,66,72,229
S9306,Helen Rorick,4,34,34,72
S9307,Terrance Switzer,42,75,57,174
S9308,Brett Longoria,47,83,96,226
S9309,Laverne Long,36,91,86,213
S9310,Carol Yang,62,63,62,187
S9311,Delores Gutman,5,72,88,165
S9312,Agnes Tanner,62,22,21,105
S9313,Lisa Mcenaney,95,61,98,254
S9314,Mary Pyron,74,36,19,129
S9315,Christine Kemmerer,36,37,45,118
S9316,Evelyn Hart,14,32,4,50
S9317,Janet Pesqueira,18,97,63,178
S9318,Gladys Carson,86,35,66,187
S9319,Patrick Motley,45,82,51,178
S9320,Albert Harrison,48,45,82,175
S9321,Jeanne Brown,55,32,33,120
S9322,Darlene Douglas,60,86,82,228
S9323,William Harrison,76,93,20,189
S9324,Shirley Ulrich,60,39,54,153
S9325,Scott Mcculler,25,93,22,140
S9326,Katherine Alfred,14,40,97,151
S9327,Danielle Hebert,94,50,95,239
S9328,Mary Obrien,21,78,55,154
S9329,Billy Soriano,36,7,60,103
S9330,Peggy Emerson,47,67,23,137
S9331,Albert Fenstermacher,7,25,44,76
S9332,Lois Follmer,31,17,30,78
S9333,William Russell,76,26,11,113
S9334,Jennifer Whitlock,87,63,20,170
S9335,Joanne Willis,12,93,6,111
S9336,Cathleen Provencher,41,37,97,175
S9337,Tracy Duran,58,71,84,213
S9338,Justin Hardin,93,88,44,225
S9339,Gerald Mcgeeney,36,11,11,58
S9340,Esther Kibby,1,25,11,37
S9341,Jordan Canning,44,40,61,145
S9342,Pablo Malin,54,13,42,109
S9343,Vanesa Allen,46,13,48,107
S9344,Daniel Issac,5,87,24,116
S9345,William Glueck,0,48,91,139
S9346,Tyrone Lopez,44,100,33,177
S9347,Herbert Novak,46,26,24,96
S9348,Martin Brown,85,93,56,234
S9349,Joan Mackenzie,41,70,6,117
S9350,Joan Mccann,59,31,21,111
S9351,Paul Parker,81,13,2,96
S9352,Maria Huskey,8,17,41,66
S9353,Christina Doherty,11,87,13,111
S9354,Bryant Graven,28,60,9,97
S9355,Bradly Monroe,71,78,81,230
S9356,Curtis Keith,75,37,33,145
S9357,Dan Munoz,58,1,74,133
S9358,Dorothy Roldan,45,3,77,125
S9359,Richard Speight,51,18,28,97
S9360,Tracy Kreisher,39,61,72,172
S9361,Amy French,55,35,15,105
S9362,Stephen Nelson,67,65,99,231
S9363,Joseph Jacobs,65,48,54,167
S9364,Julie Howard,55,37,30,122
S9365,Duncan Williams,39,30,17,86
S9366,Merrill Werra,89,76,18,183
S9367,Mark Wagner,83,4,68,155
S9368,Erika Douglas,47,12,28,87
S9369,Richard Nkomo,39,8,9,56
S9370,Jeffrey Miller,80,72,86,238
S9371,Angela Bufkin,28,87,18,133
S9372,Ralph Kawai,34,73,85,192
S9373,Daniel Roberts,21,2,8,31
S9374,Aaron Odom,6,63,68,137
S9375,Mary Paz,64,45,55,164
S9376,Bruce James,98,100,59,257
S9377,Janet Welch,41,51,8,100
S9378,Jane Huitink,44,77,29,150
S9379,Betty Couch,83,9,97,189
S9380,Viola Tracy,86,76,28,190
S9381,Larry Eubanks,37,22,7,66
S9382,Annie Avila,34,42,37,113
S9383,Delmy Reynolds,20,84,91,195
S9384,Melissa Whitham,80,98,26,204
S9385,Brandon Ricks,39,36,52,127
S9386,Brooke Thomas,21,8,50,79
S9387,Perry Mcdonald,50,96,12,158
S9388,Michael Maestas,29,81,97,207
S9389,Jose Bingham,64,17,8,89
S9390,Lance Sanders,93,81,60,234
S9391,Theodore Cole,89,29,56,174
S9392,Virginia Garcia,56,93,57,206
S9393,Margaret Nottingham,23,78,19,120
S9394,James Gautam,80,0,45,125
S9395,Eva Kelly,28,43,22,93
S9396,James Faber,33,87,38,158
S9397,Marjorie Sleeper,0,11,84,95
S9398,Denise Johnson,21,52,61,134
S9399,Michelle Weller,83,12,34,129
S9400,Kenneth Morley,94,83,83,260
S9401,Blanche Reynolds,17,76,70,163
S9402,Deborah Emery,85,35,85,205
S9403,Marianne Thomas,95,49,30,174
S9404,Peter Sylvestre,82,55,0,137
S9405,David Paul,83,11,79,173
S9406,Eugenia Newman,95,43,43,181
S9407,Sarah Pace,74,13,43,130
S9408,Jessie Meade,67,21,9,97
S9409,Tricia Gilfillan,90,65,61,216
S9410,Erica Wilkes,85,9,19,113
S9411,George Darby,38,76,62,176
S9412,Gerald Clifford,38,71,86,195
S9413,Mark Tew,25,76,33,134
S9414,Johnnie Maley,93,53,44,190
S9415,Dennis Botta,4,23,26,53
S9416,Ida Kasprzak,6,77,18,101
S9417,Diane Wise,97,10,13,120
S9418,Darcy Kostura,63,74,17,154
S9419,Miguel Petersen,92,75,39,206
S9420,Richard Phelps,8,36,97,141
S9421,Mary Goodwin,1,3,60,64
S9422,Mary Chevere,42,92,38,172
S9423,Fredric Moran,24,43,70,137
S9424,Lori Herman,93,62,12,167
S9425,Christopher Allen,57,58,31,146
S9426,Alberta Spurgeon,78,55,27,160
S9427,Henry Cedillo,34,38,100,172
S9428,Jon Brown,59,59,24,142
S9429,Jill Kaufmann,65,30,74,169
S9430,Harry White,21,2,98,121
S9431,Kevin Hirkaler,29,19,28,76
S9432,Megan Sivels,34,22,10,66
S9433,April Daigle,79,41,55,175
S9434,Martha Leslie,6,34,85,125
S9435,Dusty Bryce,38,26,30,94
S9436,Josephine Keys,21,61,60,142
S9437,Christopher Kelcourse,77,48,91,216
S9438,Dan Cano,6,42,25,73
S9439,Barbara Baskin,33,12,29,74
S9440,Carl Keaney,43,63,50,156
S9441,Barbara Humphrey,91,61,71,223
S9442,David Kovach,47,93,86,226
S9443,Jason Blue,16,58,59,133
S9444,Ryan Garcia,10,67,0,77
S9445,Frances Gonzales,44,31,79,154
S9446,Kurtis Burritt,91,78,80,249
S9447,Ralph Rhudy,90,83,24,197
S9448,Sandra Espinal,67,25,37,129
S9449,Brigette Langdon,75,81,26,182
S9450,Michael Griffith,14,3,56,73
S9451,Evelyn Clark,54,12,7,73
S9452,Brandon Denson,69,16,29,114
S9453,William Byfield,72,0,68,140
S9454,Deborah Fendler,93,98,97,288
S9455,Nancy Gant,56,2,46,104
S9456,Ethel Yohe,89,97,36,222
S9457,John Fender,72,53,19,144
S9458,Faye Gentry,12,78,84,174
S9459,Steven Musselman,67,14,23,104
S9460,Eve Graham,74,28,42,144
S9461,Bryan Turner,90,7,34,131
S9462,Joseph Holston,48,79,83,210
S9463,Cheryl Lake,22,15,58,95
S9464,Devon Robertson,60,32,83,175
S9465,Marvin Fillare,51,90,73,214
S9466,Deandre Kleeb,78,35,28,141
S9467,Carrie Rego,3,48,41,92
S9468,Dorothy Kovach,84,30,20,134
S9469,Ernest Johnson,26,38,85,149
S9470,William Thomas,49,57,52,158
S9471,Mike Gross,56,33,52,141
S9472,Esther Hopper,100,55,82,237
S9473,Maria Carr,18,44,54,116
S9474,Freda Westphalen,27,33,79,139
S9475,Cristina Washington,46,26,2,74
S9476,Ruthann Stribling,64,87,54,205
S9477,Crystal Jackson,12,9,48,69
S9478,Ronald Fletcher,19,9,66,94
S9479,Robert Obrien,84,64,86,234
S9480,Steven Parker,15,25,50,90
S9481,Jessica Murphy,1,18,74,93
S9482,Violet Chaney,87,69,33,189
S9483,Amos Boeke,37,83,50,170
S9484,James Sanchez,51,52,100,203
S9485,Jean Johnson,50,36,92,178
S9486,Raymond Ballard,69,43,26,138
S9487,Rebecca Piatek,5,39,84,128
S9488,Joe Coger,94,95,85,274
S9489,Kathleen Brinkley,62,27,30,119
S9490,Dan Canales,91,41,86,218
S9491,Jane Coleman,85,96,77,258
S9492,Sarah Nielsen,63,20,68,151
S9493,Agnes Jackson,10,54,96,160
S9494,Tammy Talamo,27,79,16,122
S9495,Raymond Smith,52,50,18,120
S9496,Cecile Carlton,0,40,40,80
S9497,Anthony Niehaus,17,85,30,132
S9498,Brenda Duke,34,56,67,157
S9499,Kurt Hayman,31,55,39,125
S9500,Marlene Haag,88,65,43,196
S9501,George Henderson,96,66,34,196
S9502,Thomas Hopper,22,23,3,48
S9503,Catherine Walker,9,0,49,58
S9504,Jerry Carson,72,40,37,149
S9505,Nancy Hathaway,43,93,76,212
S9506,Danielle Castillo,50,46,31,127
S9507,Frank Ronning,36,38,45,119
S9508,Rhonda Neal,67,17,91,175
S9509,Rodney Adams,39,6,32,77
S9510,Jesse Williamson,77,51,62,190
S9511,Deborah Mann,42,48,96,186
S9512,Jan Phillips,4,92,32,128
S9513,Jeremy Wright,21,20,67,108
S9514,Beth Sluka,24,34,80,138
S9515,Shari Whitfield,62,53,86,201
S9516,Debra Torres,29,17,91,137
S9517,Melissa Mcghee,50,37,39,126
S9518,Mark Livingston,78,8,55,141
S9519,Jordan Conner,3,84,34,121
S9520,Janice Gary,38,23,17,78
S9521,Emily Breslin,58,23,53,134
S9522,Vanessa Hall,97,34,52,183
S9523,Tamara Nolette,42,32,41,115
S9524,Diego Campbell,83,80,9,172
S9525,Donald Bossey,60,26,18,104
S9526,Daniel Mccoy,66,91,78,235
S9527,Bobbie Johnson,63,39,95,197
S9528,Marilyn Best,98,0,5,103
S9529,Donald Newton,22,5,64,91
S9530,Gregory Harris,44,57,62,163
S9531,Dorothy Jones,23,75,23,121
S9532,Bobby Riddick,35,82,8,125
S9533,Aubrey Rios,67,33,45,145
S9534,Francesca Magnuson,51,28,9,88
S9535,Walter Garrido,63,88,22,173
S9536,Regina White,99,39,38,176
S9537,Mellisa Killay,81,20,2,103
S9538,Anthony Sturgeon,48,29,59,136
S9539,Robert Zeger,44,64,77,185
S9540,Robert Pacheco,23,75,19,117
S9541,Marvin Petersen,68,96,15,179
S9542,Jessica Mcadams,7,73,93,173
S9543,Clifton Bradford,36,84,62,182
S9544,Richard Butler,56,66,24,146
S9545,Jeanette Hill,98,63,36,197
S9546,Refugio Tith,37,74,95,206
S9547,Jennifer Wiggains,11,21,29,61
S9548,Joy Garvey,80,72,59,211
S9549,Charles Grant,56,57,23,136
S9550,Arthur Peters,62,34,15,111
S9551,Jerry Stermer,2,18,94,114
S9552,Bettie Patterson,90,79,98,267
S9553,Evette Rivard,76,54,53,183
S9554,Kevin Hinzman,41,94,71,206
S9555,Yolanda Morris,37,14,29,80
S9556,Tommy Duval,27,55,45,127
S9557,Alexis Jones,45,31,4,80
S9558,Margaret Phelps,31,70,57,158
S9559,Erica Walter,29,88,67,184
S9560,Patricia Takata,100,63,46,209
S9561,Jed Johnson,64,80,19,163
S9562,Hayden Frank,39,62,1,102
S9563,Elizabeth Edmondson,48,23,29,100
S9564,Renae Styles,79,5,38,122
S9565,Betty Bonifant,53,47,88,188
S9566,Patricia Holtz,95,37,92,224
S9567,Tom James,88,58,68,214
S9568,Kara Smith,94,93,77,264
S9569,Lorrie Adkins,85,71,16,172
S9570,Ronald Cabrera,40,34,78,152
S9571,Cathleen Spivey,74,60,65,199
S9572,Delbert Zeller,88,50,91,229
S9573,Stefani Fisher,84,33,28,145
S9574,Linda Riso,23,55,44,122
S9575,Dorothy Takata,42,95,0,137
S9576,Madeleine Sams,85,23,97,205
S9577,Hans Thomsen,60,79,9,148
S9578,Philip Ford,6,20,22,48
S9579,Shawnda Higgins,19,27,82,128
S9580,Gilbert Moore,82,61,36,179
S9581,Lesley Hudson,39,18,1,58
S9582,Joseph Martone,66,56,2,124
S9583,Stephen Tarango,60,2,79,141
S9584,Tammie Sharp,47,76,38,161
S9585,Robert Colon,12,63,71,146
S9586,Lou Mccartney,90,57,36,183
S9587,Joel Chesser,24,100,76,200
S9588,Charles Weiss,86,49,56,191
S9589,Hilda Gould,20,41,11,72
S9590,Charlotte Wilson,61,10,35,106
S9591,Kareem Turner,59,44,38,141
S9592,Betty Holbert,56,96,35,187
S9593,Lena Fields,23,36,82,141
S9594,Cathy Lutz,75,39,87,201
S9595,Melissa Galante,95,28,70,193
S9596,Lorraine Throgmorton,51,10,14,75
S9597,Michael Burt,66,88,2,156
S9598,Laurence Conn,59,96,72,227
S9599,Gloria Horton,36,100,8,144
S9600,Phyllis Gordon,19,52,73,144
S9601,Brian Dancy,95,67,77,239
S9602,Jane Mcconnell,34,62,61,157
S9603,Judith Wilson,45,98,85,228
S9604,Irene Sanchez,66,41,6,113
S9605,Kristina Adams,89,54,66,209
S9606,George Boyd,81,88,12,181
S9607,Ada Marx,4,5,57,66
S9608,James Quear,100,13,88,201
S9609,Ilda Wallace,7,67,35,109
S9610,Richard Tate,93,28,67,188
S9611,Christine Hurless,14,100,79,193
S9612,Frank Zubia,71,56,28,155
S9613,Joseph Jones,27,77,99,203
S9614,Matt Mckain,42,28,80,150
S9615,Jane Schmig,92,28,23,143
S9616,Tisha Hall,50,56,95,201
S9617,Rebecca Hatton,66,31,1,98
S9618,William Boldosser,14,41,51,106
S9619,Mary Watring,43,74,11,128
S9620,Fred Webster,16,44,30,90
S9621,Marc Banks,74,49,74,197
S9622,Kenneth Morgan,30,39,11,80
S9623,Mark Northern,80,60,91,231
S9624,Lorraine Bonner,6,22,45,73
S9625,Jason Vilain,91,23,5,119
S9626,Charles Apolo,75,73,35,183
S9627,Robert Vereen,25,35,83,143
S9628,Jada Malone,68,60,53,181
S9629,Brad Dooley,81,50,17,148
S9630,Charles Friend,54,16,50,120
S9631,Ruth Clowney,34,9,69,112
S9632,Steven Miner,67,78,53,198
S9633,Christina Herring,27,92,81,200
S9634,Juan Wishart,34,49,3,86
S9635,George Ewell,30,4,39,73
S9636,Teresa Chapman,77,63,49,189
S9637,Jeff Williams,49,4,57,110
S9638,Jenny Moss,42,27,6,75
S9639,Amos Cunningham,78,82,98,258
S9640,Elsa Gustafson,14,42,15,71
S9641,Josephine Walters,96,27,80,203
S9642,Libby Johnson,34,93,80,207
S9643,Barbara George,4,81,80,165
S9644,Pamela Cha,39,49,36,124
S9645,Willie Barretta,54,49,53,156
S9646,Sidney Beyer,28,87,83,198
S9647,Dale Young,66,27,60,153
S9648,Jerry Gibbs,2,35,46,83
S9649,Kathrine Woods,59,39,35,133
S9650,Larry Ainsworth,83,23,45,151
S9651,Henry Garces,54,71,96,221
S9652,Matthew Jones,33,82,46,161
S9653,Jessica Dolan,62,21,99,182
S9654,Marion Rios,65,36,73,174
S9655,Kenneth Baker,65,97,65,227
S9656,Van Pittman,43,47,5,95
S9657,Bertha Bouillon,97,55,49,201
S9658,Betty Linn,77,51,98,226
S9659,Sylvia Ward,35,24,26,85
S9660,Gary Baez,97,100,60,257
S9661,Theresa Haddock,45,25,81,151
S9662,Judith Kurtz,71,32,83,186
S9663,Ronald Brown,78,22,40,140
S9664,Maria Hensley,81,64,90,235
S9665,Jessie Taylor,90,59,65,214
S9666,Wayne Solorio,87,41,5,133
S9667,Gracie Henry,29,75,76,180
S9668,Gary Halpin,63,30,14,107
S9669,Willie Duffey,21,78,63,162
S9670,Richard Garcia,29,96,61,186
S9671,Phillip Carsey,61,7,86,154
S9672,Rachelle Ferguson,18,55,34,107
S9673,Stephanie Loyd,3,56,17,76
S9674,Tatiana Rape,45,89,5,139
S9675,Marjorie Chappell,72,49,76,197
S9676,Shawn Portugal,77,34,34,145
S9677,Stephanie Aquino,0,97,8,105
S9678,Erin Adams,81,37,43,161
S9679,Tommy Clark,47,19,19,85
S9680,Joseph Baker,12,14,31,57
S9681,Anna Stowers,82,65,75,222
S9682,Doris Washington,99,87,47,233
S9683,Janet Dulin,87,49,91,227
S9684,Joseph Brown,39,73,49,161
S9685,Julie Harris,95,75,88,258
S9686,Titus Snyder,60,11,28,99
S9687,Michael Tornow,6,69,75,150
S9688,Jorge Shouse,61,37,80,178
S9689,Mark Tedesco,51,100,77,228
S9690,Marquita Pearson,24,1,62,87
S9691,Santina Otero,48,96,53,197
S9692,Florence Rodriguez,25,96,21,142
S9693,Robert Odea,66,87,74,227
S9694,Leslie Smith,39,23,61,123
S9695,Tommie Werner,37,38,19,94
S9696,Russell Moore,75,59,48,182
S9697,Gene Mendoza,31,21,85,137
S9698,Rae Mitchell,10,82,58,150
S9699,Frank Brown,60,51,26,137
S9700,Kelly Munoz,36,1,24,61
S9701,James Barber,36,83,69,188
S9702,Tammy Weaver,11,78,100,189
S9703,Clyde Oliver,37,77,65,179
S9704,Marie Davis,15,68,90,173
S9705,Charles Taylor,31,37,59,127
S9706,Jacob Becker,64,90,43,197
S9707,Ruth Mckinzie,62,93,46,201
S9708,Debra Herrera,82,53,18,153
S9709,Norma Rutherford,57,9,37,103
S9710,Cecil Mcgee,12,88,90,190
S9711,Gregory Harris,54,78,4,136
S9712,Kenneth Rotenberry,94,82,62,238
S9713,Jose Taylor,65,0,22,87
S9714,Dan Deering,37,3,11,51
S9715,Amanda Brown,15,47,75,137
S9716,Alan Greene,17,83,23,123
S9717,Hector Webb,87,18,97,202
S9718,Philip Tidwell,3,2,56,61
S9719,Dixie Bail,27,72,45,144
S9720,John Rankin,79,14,10,103
S9721,Corey Delatorre,0,79,82,161
S9722,Rick Jessup,90,20,28,138
S9723,Marjorie Hofer,45,96,50,191
S9724,Michaela Villarreal,20,0,70,90
S9725,Chiquita Stearns,64,79,28,171
S9726,Betty Williams,40,41,46,127
S9727,Leontine Alexander,82,4,11,97
S9728,Mildred Sollie,29,5,54,88
S9729,Diane Reiter,58,74,20,152
S9730,Michelle Austin,74,92,20,186
S9731,Edgar Edwards,36,5,53,94
S9732,Kathlyn Dishman,19,89,76,184
S9733,David Sheridan,70,32,98,200
S9734,Lela Tobar,46,50,75,171
S9735,Daniel Demirchyan,72,27,9,108
S9736,Judi Queen,75,63,37,175
S9737,Catherine Chesser,31,10,40,81
S9738,Paul Starnes,34,82,1,117
S9739,Donald Dean,3,41,73,117
S9740,Stephen Delapena,68,38,9,115
S9741,Mary Hough,60,24,9,93
S9742,Doris Smith,77,0,2,79
S9743,Alecia Coles,62,43,42,147
S9744,Laurie Stine,1,55,42,98
S9745,Cody Wilson,78,72,8,158
S9746,Ashleigh Watts,12,46,28,86
S9747,Ethel Livingston,14,59,3,76
S9748,Roy Stuart,7,55,5,67
S9749,Brenda Richardson,43,97,41,181
S9750,Amy Moore,51,46,85,182
S9751,Mathew Owens,20,90,42,152
S9752,Anissa Anderson,1,54,2,57
S9753,Ricardo Johnson,6,97,44,147
S9754,Shanta Bateman,38,20,46,104
S9755,Jeanine Mcnair,5,41,14,60
S9756,John Watson,24,55,30,109
S9757,Sheree Gugler,8,5,42,55
S9758,Sherri Brown,17,81,94,192
S9759,Antonio Flickinger,6,77,40,123
S9760,Joan James,46,38,40,124
S9761,Helena Mullings,0,82,1,83
S9762,Mandy Gray,96,33,88,217
S9763,Joseph Davis,99,92,15,206
S9764,Babette Morris,45,82,43,170
S9765,Arturo Peck,98,85,62,245
S9766,Carmine Rathbun,63,34,80,177
S9767,Stuart Harris,36,97,73,206
S9768,William Quimby,43,0,86,129
S9769,Tara Redfield,79,9,57,145
S9770,Simon Navarra,56,7,93,156
S9771,Betty Vanderhorst,98,18,3,119
S9772,Janice Roach,25,73,37,135
S9773,Helen Williams,70,78,28,176
S9774,Robert David,73,80,59,212
S9775,Maria Stephens,73,22,51,146
S9776,Ervin Savage,96,57,96,249
S9777,Nona Steffen,4,3,76,83
S9778,James Pack,18,14,100,132
S9779,Elizabeth Morgan,62,34,32,128
S9780,Elizabeth Childress,7,67,47,121
S9781,Glenda Baez,81,72,78,231
S9782,Dale Despain,13,41,98,152
S9783,Mark Ross,70,73,59,202
S9784,Helen Mcglade,93,32,91,216
S9785,Aldo Mainor,55,46,8,109
S9786,Douglas Hyman,49,53,15,117
S9787,Trina Bailey,7,97,38,142
S9788,Lois Rodriguez,41,25,93,159
S9789,Adam Tow,74,11,13,98
S9790,Jose Becnel,66,58,21,145
S9791,Sharon Woods,29,86,71,186
S9792,Samuel Jackson,2,81,24,107
S9793,Herbert Hall,16,79,76,171
S9794,David Menendez,99,73,96,268
S9795,Michael Wigginton,47,4,85,136
S9796,Richard Jackson,28,100,53,181
S9797,Daniel Mills,26,25,28,79
S9798,Cecil Hopkins,12,3,76,91
S9799,Michael Mcclinton,94,91,73,258
S9800,John Merryman,1,30,32,63
S9801,Susan Cato,0,84,16,100
S9802,Alec Henry,37,98,36,171
S9803,Linette Yost,100,59,77,236
S9804,Sandra Cotney,32,10,68,110
S9805,Mack Morris,70,61,31,162
S9806,Brenna Mounsey,4,88,69,161
S9807,Ina Chatman,28,24,55,107
S9808,Martin Horio,12,23,23,58
S9809,Richard Tino,94,58,19,171
S9810,Garrett Jennings,41,2,22,65
S9811,Daniel Green,10,46,76,132
S9812,Lillian Beach,11,99,27,137
S9813,Michael Molina,65,31,60,156
S9814,Robert Page,70,69,53,192
S9815,Jeannie Minton,91,80,12,183
S9816,Chanda Hayes,8,27,17,52
S9817,Markus Cooper,57,14,11,82
S9818,Stephanie Ratcliff,24,50,14,88
S9819,Elijah Harkavy,69,25,35,129
S9820,Jennifer Thompson,68,81,58,207
S9821,Patricia Cost,93,42,72,207
S9822,Jodi Lambert,58,39,4,101
S9823,Crystal Mattie,23,83,42,148
S9824,Maudie Austin,85,5,92,182
S9825,Galina Daniels,22,47,84,153
S9826,John Patten,56,21,66,143
S9827,Dennis Brown,22,83,27,132
S9828,Michael Walton,100,54,24,178
S9829,Willie Fagerstrom,87,25,79,191
S9830,Barbara Woods,70,73,61,204
S9831,Genevieve Grant,50,81,52,183
S9832,Tanya Nemith,21,37,97,155
S9833,Micheal Bieber,26,59,42,127
S9834,Alfredo Alexander,56,69,69,194
S9835,Nora Jaeger,68,8,81,157
S9836,Joel Dowell,24,85,91,200
S9837,Claudia Peterson,41,68,0,109
S9838,Cheryl Toft,83,36,37,156
S9839,Minnie Jones,45,48,91,184
S9840,Elizabeth Greenfield,52,88,66,206
S9841,Kenneth Gordon,59,54,50,163
S9842,Chris Heidt,44,23,79,146
S9843,Barbara Dusel,10,10,35,55
S9844,Emily Letko,63,8,28,99
S9845,Carol Aschenbrenner,51,59,75,185
S9846,Edward Hill,59,71,100,230
S9847,Fausto Santiago,5,25,21,51
S9848,Jennifer Nichols,29,25,19,73
S9849,Donald Taylor,42,31,40,113
S9850,Brandy Lewis,80,34,65,179
S9851,Carmela Collins,40,17,34,91
S9852,Darwin Burkett,15,98,41,154
S9853,Danny Waldman,35,92,24,151
S9854,John Ashcraft,97,40,69,206
S9855,James King,48,55,4,107
S9856,Patricia Torres,6,82,8,96
S9857,Francisca Diggins,31,35,93,159
S9858,Jeanna Gauvin,34,21,94,149
S9859,Richard Berry,83,85,28,196
S9860,Priscilla Hollomon,97,26,73,196
S9861,Bonnie Conder,15,11,50,76
S9862,James Hoy,88,36,72,196
S9863,Darius Putney,57,34,49,140
S9864,Edward Johnson,99,87,68,254
S9865,John Sheekey,19,3,10,32
S9866,Jenny Fitzgerald,7,2,40,49
S9867,Cassandra Jones,64,2,51,117
S9868,Jacqueline Desotel,16,32,100,148
S9869,David Torres,80,97,65,242
S9870,Betty Johnson,78,18,44,140
S9871,Micheal Middleton,16,94,77,187
S9872,Johnny Lewis,23,95,31,149
S9873,Daniel Bowles,54,27,4,85
S9874,Michael Everson,49,56,5,110
S9875,Sally Husband,69,70,23,162
S9876,Mary Lorentz,40,74,95,209
S9877,Willie Koenitzer,79,63,92,234
S9878,Daniel Watson,80,23,17,120
S9879,Regina Vroom,72,53,71,196
S9880,Terry Gallagher,98,22,99,219
S9881,Basil Nunes,3,9,49,61
S9882,Amanda Cheatham,83,62,89,234
S9883,Randal Capps,17,87,52,156
S9884,Tom Perez,19,53,41,113
S9885,Michael Shipley,40,66,78,184
S9886,George Magdaleno,93,54,26,173
S9887,John White,45,2,28,75
S9888,Margaret Chapman,78,24,49,151
S9889,Emily Williams,54,18,17,89
S9890,James Leishman,36,0,96,132
S9891,George Weiss,86,49,39,174
S9892,Robert Coleman,92,53,11,156
S9893,James Nagy,7,30,46,83
S9894,Chris Hayman,42,50,35,127
S9895,Virginia Trent,5,51,40,96
S9896,Adriana Ramey,21,68,0,89
S9897,James Rodriguez,37,0,49,86
S9898,George Helf,35,60,6,101
S9899,Craig Campbell,6,82,41,129
S9900,Ricardo Williams,13,76,43,132
S9901,Edward Thaniel,16,20,77,113
S9902,Peter Roderick,64,82,93,239
S9903,Ricardo Tapia,69,66,85,220
S9904,Gerald Shook,16,92,97,205
S9905,George Garstka,7,8,2,17
S9906,James Walker,46,62,42,150
S9907,Mary Arpin,55,6,2,63
S9908,Joseph Roman,4,31,92,127
S9909,Gloria Kiernan,60,42,4,106
S9910,Jason Sturdevant,40,6,33,79
S9911,Jenny Zambrano,2,46,46,94
S9912,Robert Wiser,32,41,77,150
S9913,Martha Flores,64,35,83,182
S9914,Samantha Heon,19,67,75,161
S9915,Marianne Christman,90,94,99,283
S9916,Linda Early,24,63,32,119
S9917,Sharon Penwell,61,56,30,147
S9918,Retha Terhune,37,50,27,114
S9919,Lori Dunlap,13,32,19,64
S9920,Juan Sallie,100,54,91,245
S9921,Deanna Debuhr,24,70,90,184
S9922,Norman Davis,59,44,72,175
S9923,Stanley Herrera,59,25,98,182
S9924,Carol Anglin,50,96,87,233
S9925,Anthony Mcpherson,44,81,95,220
S9926,Bryan Loman,10,21,7,38
S9927,Phillip Barnes,88,70,48,206
S9928,Bobbie Johnson,62,68,81,211
S9929,Angela Foster,7,86,56,149
S9930,Dale May,35,0,97,132
S9931,Anthony Wyss,10,82,19,111
S9932,Larry Kruger,32,9,30,71
S9933,Eugene Doty,5,99,24,128
S9934,Mildred Bishop,14,87,14,115
S9935,Patrick Roberts,41,42,11,94
S9936,Donald Handy,83,86,7,176
S9937,Elizabeth Jackson,73,27,10,110
S9938,Edna Jameson,70,83,62,215
S9939,Phung Wessel,10,68,28,106
S9940,Barbara Palmer,27,77,33,137
S9941,Brandi Thrift,46,14,82,142
S9942,John Bruce,12,47,97,156
S9943,Delores Barber,80,94,15,189
S9944,Karen Marquis,42,53,37,132
S9945,Alexander Scharfenberg,13,13,74,100
S9946,Kirby Grey,58,53,15,126
S9947,Isreal Saba,32,14,0,46
S9948,Donna Jones,10,72,2,84
S9949,Anthony Brown,84,58,26,168
S9950,Bryan Labrum,97,88,17,202
S9951,Frank Moody,12,95,26,133
S9952,John Prince,71,14,61,146
S9953,Lois Bennett,61,73,47,181
S9954,Trey Pelley,8,61,95,164
S9955,Jimmy Ingram,80,100,21,201
S9956,John Crawford,53,15,64,132
S9957,Cassandra Clark,29,1,90,120
S9958,Marlene Woods,45,32,61,138
S9959,Arthur Manylath,28,16,61,105
S9960,Judy Grady,56,69,40,165
S9961,George Ketchum,79,82,34,195
S9962,Danny Hamilton,77,10,28,115
S9963,Lee Howe,91,14,62,167
S9964,Christopher Mullens,90,87,70,247
S9965,Neva Stengle,13,18,28,59
S9966,Oscar Morris,31,64,36,131
S9967,Peggy Ahr,90,38,25,153
S9968,Adrian Womack,73,82,6,161
S9969,Gilbert Posey,82,92,66,240
S9970,Christopher Fort,14,39,90,143
S9971,Curtis Vento,10,17,22,49
S9972,Sean Picton,52,57,60,169
S9973,Ashley Mazza,65,62,20,147
S9974,Julio Snyder,16,7,23,46
S9975,Jennifer Campbell,10,58,46,114
S9976,James Davis,0,88,3,91
S9977,David Ramirez,48,77,18,143
S9978,Christopher Miller,62,97,39,198
S9979,Lois Williams,45,4,79,128
S9980,Gay Smith,0,47,13,60
S9981,Charles Northup,9,96,42,147
S9982,Debbie Harris,100,12,42,154
S9983,John Harris,93,40,100,233
S9984,Brian Chew,37,100,17,154
S9985,Robert Johnson,64,54,29,147
S9986,Elisha Hawkins,71,48,14,133
S9987,Troy Graham,51,61,47,159
S9988,Holly Cody,59,60,61,180
S9989,Genoveva Lafayette,30,88,65,183
S9990,Tiffany Woods,76,58,26,160
S9991,Jeffrey Galicia,100,14,13,127
S9992,Natalie Leitheiser,94,45,67,206
S9993,Rose Kwong,61,66,53,180
S9994,Shirley Christopher,58,74,100,232
S9995,Mark Smith,32,47,93,172
S9996,Jamie Ming,86,16,1,103
S9997,Shirley Garstka,17,27,76,120
S9998,Charlene Chan,61,61,8,130
S9999,Ruth Willman,55,1,22,78
S10000,Douglas Bussen,49,56,91,196
